#domain
hospital
#levelname
photo
#colors
green: 0, A, C
brown: 1, B, D
orange: 2, E, F
pink: 3, G
grey: 4, H
lightblue: 5, I
red: 6, 
blue: 7, 
#initial
++++++++++++++++++++++++++++++++++++++++++++++++++++++++++++++++++++++++++++++++++++++++++++++++++++++++++++++++++++++++++++++++++++++++++++++
+GGGGGGGGGGGGGGGGGGGGGGGGGGGGGGGGGGGGGGGGGGGGGGGGGGGGGGGGGGGGGGGGGGGGGGGGGGGGGGGGGGGGGGGGGGGGGGGGGGGGGGGGGGGGGGGGGGGGGGGGGGGGGGGGGGGGGGGGIGGG+
+GGGGGGGGGGGGGGGGGGGGGGGGGGGGGGGGGGGGGGGGGGGGGGGGGGGGGGGGGGGGGGGGGGGGGGGGGGGGGGGGGGGGGGGGGGGGGGGGGGGGGGGGGGGGGGGGGGGGGGGGGGGGGGGGGGGGGGGGGGGG+
+GGGGGGGGGGGGGGGGGGGGGGGGGGGGGGGGGGGGGGGGGGGGGGGGGGGGGGGGGGGGGGGGGGGGGGGGGGGGGGGGGGGGGGGGGGGGGGGGGGGGGGGGGGGGGGGGGGGGGGGGGIIGGIIIIIIIIIIIIIIG+
+GGGGGGGGGGGGGGGGGGGGGGGGGGGGGGGGGGGGGGGGGGGGGGGGGGGGGGGGGGGGGGGGGGGGGGGGGGGGGGGGGGGGGGGGGGGGGGGGGGGGGGGGGGGGGGGGGGGGGGGGGGGGGGIIIIIIIIIIIIIG+
+GGGGGGGGGGGGGGGGGGGGGGGGGGGGGGGGGGGGGGGGGGGGGGGGGGGGGGGGGGGGGGGGGGGGGGGGGGGGGGGGGGGGGGGGGGGGGGGGGGGGGGGGGGGGGGGGGGGGGGGGGGGGGGGIIIIIIIIIIIIG+
+GGGGGGGGGGGGGGGGGGGGGGGGGGGGGGGGGGGGGGGGGGGGGGGGGGGGGGGGGGGGGGGGGGGGGGGGGGGGGGGGGGGGGGGGGGGGGGGGGGGGGGGGGGGGGGGGGGGGGGGGGGGGGGGIIIIIIIIIIIIG+
+GGGGGGGGGGGGGGGGGGGGGGGGGGGGGGGGGGGGGGGGGGGGGGGGGGGGGGGGGGGGGGGGGGGGGGGGGGGGGGGGGGGGGGGGGGGGGGGGGGGGGGGGGGGGGGGGGGGGGGGGGIIIIIIIIIIIIIIIIIIG+
+GGGGGGGGGGGGGGGGGGGGGGGGGGGGGGGGGGGGGGGGGGGGGGGGGGGGGGGGGGGGGGGGGGGGGGGGGGGGGGGGGGGGGGGGGGGGGGGGGGGGGGGGGGGGGGGGGGGGGGGGGIIIIIIIIIIIIIIIIIIG+
+GGGGGGGGGGGGGGGGGGGGGGGGGGGGGGGGGGGGGGGGGGGGGGGGGGGGGGGGGGGGGGGGGGGGIGGGGGGGIIGGGGGGGGGGGGGGGGGGGGGGGGGGGGGGGGGGGGGGGGGGGIIIIIIIIIIIIIIIIIIG+
+GGGGGGGGGGGGGGGGGGGGGGGGGGGGGGGGGGGGGGGGGGGGGGGGGGGGGGGGGGGGGIIIGGIIGIIIIGGGGIGGGGGGGGGGGGGGGGGGGGGGGGGGGGGGGGGGGGGGGGGGGIIIIIIIIIIIIIIIIIIG+
+GGGGGGGGGGGGGGGGGGGGGGGGGGGGGGGGGGGGGGGGGGGGGGGGGGGGGIIGGIIGIIIHHIHHHHIHHHIIGIIGGIIIGGGGGGGGGGGGGGGGGGGGGGGGGGGGGGGGGGGGGIIIIIIIIIIIIIIIIIIG+
+GGGGGGGGGGGGGGGGGGGGGGGGGGGGGGGGGGGGGGGGGGGGGGGGGIIIIIHHHHHHHHHHHHJJJHHJJHHHIIHIIHHHIGGIIGGGIGGGGGGGGGGGGGGGGGGGGGGGGGGGGIIIIIIIIIIIIIIIIIIG+
+GGGGGGGGGGGGGGGGGGGGGGGGGGGGGGGGGGGGGGGGGGGGGGGGGIGIHHHHHHHHHJJJJJJJJHHJHHHHHHHHHHHHHIHHIIIIIIGGGGGGGGGGGGGGGGGGGGGGGGGGGIIIIIIIIIIIIIIIIIIG+
+GGGGGGGGGGGGGGGGGGGGGGGGGGGGGGGGGGGGGGGGGGGGGGIGGIIHHHHJJHHHJJJJJJJJJHJHHHJJHHJHHJHJHHHHHHHIGGGGGGGGGGGGGGGGGGGGGGGGGGGGGIIIIIIIIIIIIIIIIIIG+
+GGGGGGGGGGGGGGGGGGGGGGGGGGGGGGGGGGGGGGGGGGGGIHHHHHHHHHJJJJJJJJJJJJJJHJJHJJJJJJJJJJJJJHHHJHHHHIGGGGGGGGGGGGGGGGGGGGGGGGGGGIIIIIIIIIIIIIIIIIIG+
+GGGGGGGGGGGGGGGGGGGGGGGGGGGGGGGGGGGGGIIGGGGIHJJHHHHHJJJJJJJJJJJJJJJJJJJJJJJJJHJJHJJJJHHHHHHHHHIGGIIGGGGGGGGGGGGGGGGGGGGGGIIIIIIIIIIIIIIIIIIG+
+GGGGGGGGGGGGGGGGGGGGGGGGGGGGGGGGGGGGIIIIIIHHJHJHHHHHJJJJJJJJJJJJHJJJJJJJJJJHHHHHHHHHHHHHHHHJHHHHIGIGGGGGGGGGGGGGGGGGGGGGGIIIIIIIIIIIIIIIIIIG+
+GGGGGGGGGGGGGGGGGGGGGGGGGGGGGGGGGIIIIIIHHHHHHHHHHHHHJJJJJJJJJHJJHHJJJJJJJJJJJJJHHHHHHHHJJJHJJHHHHIIIIIIIIIGGGGGGGGGGGGGGGGGIIIIIIIIIIIIIIIIG+
+GGGGGGGGGGGGGGGGGGGGGGGGGGGGGGGGGIIHHHHHHHHHHHHJJHHHHHJJJJJJJHHJJHJJJJJJJJJJJJJHHHHHHHHHHJJHJJJJHHHIIIIGIIGGGGGGGGGGGGGGGGGIIIIIIIIIIIIIIIIG+
+GGGGGGGGGGGGGGGGGGGGGGGGGGGGGGGGGGIIHHHHHHHHHJJJHHHJJJHJJJJJJJHJJHHJJJJJJJJJJJHHHHHHHHHHHHHHHHJHHHHHIGGIIGGGGGGGGGGGGGGGGGIIIIIIIIIIIIIIIIIG+
+GGGGGGGGGGGGGGGGGGGGGGGGGGGGGGGGGGIIIHHHHHHHHHHHHHHHJJHHJJJJJJHHJHHHHJJJJJJJJHHHHHHHHHHHHHHJHHHHHHHHHIIIIIIIGGGGGGGGGGGGGIIIIIIIIIIIIIIIIIIG+
+GGGGGGGGGGGGGGGGGGGGGGGGGGGGGGIIIIHHHHHHHHHHHHHHHHHHHJHHHHJJJJJHHHHHHHJJJJJJJJJJHHHJJHHHHHHHJJJJJHHHJHHHHIIIGGGGGGGGGGGGIIIIIIIIIIIIIIIIIIIG+
+GGGGGGGGGGGGGGGGGGGGGGGGGGGGGIHHHIHHHHHHHHHHHHHHHHHHHHHHHHHHHJJJHHHHHHHJJJJJJJJJHHHHHHHHHHJJJJJJHHHHJJJHHIIIIGGGGGGGGGGGIIIIIIIIIIIIIIIIIIIG+
+GGGGGGGGGGGGGGGGGGGGGGGGGGGGGIIHHHHHHHHHHHHHHHHHHHHHHHHHHHJJJJJHHHHHHHHHJJJJJJHHHHJHHHHHHHHHJJJHHHHHHHHHHHIIIIIGGGGGIIIIIIIIIIIIIIIIIIIIIIIG+
+GGGGGGGGGGGGGGGGGGGGGGGGGGGGIIHHHHHHHHHHHHHHHHHHHHJHHHHHHHHJJJJJJHHHHHHHJJJJJJHHHJJJHHHHHJJJJJHHHHHHHJHHHHHHIIIGGGGIIIIIIIIIIIIIIIIIIIIIIIIG+
+GGGGGGGGGGGGGGGGGGGGGGGGGGGIIHHHHHHHHHHHHHHHHHHHHHHJJHHHHJHHJJHJJHHHHJHHJJJJJHHHHJJJHHHHHJJJJHHHHHHJHHHJHHHJHHIIIIIIIIIIIIIIIIIIIIIIIIIIIIIG+
+GGGGGGGGGGGGGGGGGGGGGGGGGGGIIIIHHHHHHHHHHHHJJHHHHHHHHHHHJHHHHJHHJHHHHHJJHJJJJHJHHJJJHHHHJJJHHHHHHHHJJHHHHJJJHHHIIIIIIIIIIIIIIIIIIIIIIIIIIIIG+
+GGGGGGGGGGGGGGGGGGGGGGGGGGIIIIIHHHHHHHHHHHHHJHHHHHHHHHHHJJHHHHHHHHHHHHJJHHHJHHJHHJJJJHHJJJHHHHHHHHJJJHHHHJHHHHHIIIIIIIIIIIIIIIIIIIIIIIIIIIIG+
+GGGGGGGGGGGGGGGGGGGGGGGGGGGIIIIHHHHHHHHHHHHHHHHHJHHHHHHHJJHJJHHJHHHHHHHJHJHJHHJHHJJJJHHJJJHHHHHHHHHHHHJJHHHHHHHIIIGIGGIIIIIIIIIIIIIIIIIIIIIG+
+GGGGGGGGGGGGGGGGGGGGGGGGGGIIIIHHHHHHHHHHHHHHHHHHHHHHHHHHHHHJJJHJJHHHHHHHHHHHHHHHHJHJJHHHJHHHHHHHHHHHHJHHHHHHHHHIIIIGGIIIIIIIIIIIIIIIIIIIIIIG+
+GGGGGGGGGGGGGGGGGGGGGGGGGIIIIHHHHHHHHHHHHHHHHHHHHHHHHHHHHHHJJHJJHHHHHHHHHHJHHHHHJJHHJJJJHHHHHHHHHHHHHHJHHHHHHHHHHIGIIGIIIIIIIIIIIIIIIIIIIIIG+
+GGGGGGGGGGGGGGGGGGGGGGGGGGIIHHHHHHHHHHHHHHHHHHHHHHHHHHJJHHHHHHHHHHHHHHHHHHJJJHHJJJJHJJJHHHHHHHHHHHHHJHJJJHHHHHHHIIIIIGIIIIIIIIIIIIIIIIIIIIIG+
+GGGGGGGGGGGGGGGGGGGGGGGGGIIIIHHHHHHHJHHHHHHHHHHHHHHHHHHJHHHJHHHHHHHHHHHHHHHHJHHJJJJJJJHHHHHHJJJHHHHHHJJJJHHHHHHHIIIGGIIIIIIIIIIIIIIIIIIIIIIG+
+GGGGGGGGGGGGGGGGGGGGGGGGGIIIIHHHHHHHHHHHHHHHHHHHHHHHHHHJHHHJHHHHHHHHHHHHHHHHHHHHHHHHHHHHHJHJJJJJJJJJJJHHHHHHHHHHIGGGGIIIIIIIIIIIIIIIIIIIIIIG+
+GGGGGGGGGGGGGGGGGGGGGGGGGIIHHHHHHHHHHHHHHHHHHHHHHHHHHHHJHHHHJHHHHHHHHHHHHHHHJJHHHHHHHHHHHHHJJJJJJJJJJJHHHHHHHHHHHGGGGIIIIIIIIIIIIIIIIIIIIIIG+
+GGGGGGGGGGGGGGGGGGGGGGGGGIIHHHHHHHHHHHHHHHHHHHHHHHHHHHHHHHHHHHHHHHHHHHHHHHHHHHHHHHHHHHHHHHHHHJJJJJJJHHHHHHHHHHHHHIGIIGIIIIIIIIIIIIIIIIIIIIIG+
+GGGGGGGGGGGGGGGGGGGGGGGGIIHHHHHHHHHHHHHHHHHHHHHHHHHHHHHHHHHHHHHHHHHHHHHHHHHHHHHHHHHHHHHHHHHHHHJJJJJJHHHHHHHHHHHHHIGGGIIIIIIIIIIIIIIIIIIIIIIG+
+GGGGGGGGGGGGGGGGGGGGGGGGGIHHHHHHHHHHHHHHHHHHHHHHHHHHHHHHHHHHHHHHHHHHHHHHHHHHHHHHHHHHHHHHHHHHHHHJJJJJJJJJJHHHHHHHHIGIIIIIIIIIIIIIIIIIIIIIIIIG+
+GGGGGGGGGGGGGGGGGGGGGGGGGIIHHHHHHHHHHHHHHHHHHHHHHHHHHHHHHHHHHHHHHHHHHHHHHHHHHHHHHIIIIHHHHHHHHHHHHJJJJJJHHHHHHHHJHIGIIIIIIIIIIIIIIIIIIIIIIIIG+
+GGGGGGGGGGGGGGGGGGGGGGGGGIIHHHHHHHHHHHHHHHHHHHHIIHHHHHHHHHHHHHHHHHHHHHHHHHHHHHIIIIIIIIIIHHHHHHHHHHHJJJJHHHHHHHHHHHIGGIIIIIIIIIIIIIIIIIIIIIIG+
+GGGGGGGGGGGGGGGGGGGGGGGGGIHHHHHHHHHHHHHHHIIIIIIIIIIIIIIIIIIIIIIIIIIIIIIIIIIIIIIIIIIIIIIIHHHHHHHHHHHHHHHHHHHHHHHHHHIGIIIIIIIIIIIIIIIIIIIIIIIG+
+GGGGGGGGGGGGGGGGGGGGGGGGIHHHHHHHHHHHHHHIIIIIIIIIIIIIIIIIIIIIIIGGGGGGIIIIIIIIIIIIIIIIIIIIIHHHHHHHHHHHHHHHHHJJJJJJHIGIIGIIIIIIIIIIIIIIIIIIIIIG+
+GGGGGGGGGGGGGGGGGGGGGGGGIIHHHHHHHHHHHHIIIIIIIIIIIIIIIIIIIGGGGGGGGGGGGGIIIIIIIIIIIIIIIIIIIIHHHHHHHHHHHHJJJJJJJJJHHHGGGIIIIIIIIIIIIIIIIIIIIIIG+
+GGGGGGGGGGGGGGGGGGGGGGGGGIHHHHHHHHHHHIIIIIIIIIIIIIIIIIIIIGGGGGGGGGGGGGGIIIIIIIIIIIIIIIIIIIIHHHHHHHHHHHHJJJJJJJJJHHGIGIIIIIIIIIIIIIIIIIIIIIIG+
+GGGGGGGGGGGGGGGGGGGGGGGGIHHHHHHHHHHHIIIIIIIHHIIIIIIIIIIIIGGGGGGGGGGGGGGGGGGGIIIIIIIIIIIIIIIHHHHHHHHHHHHHJJJJJJJJHIIIIIIIIIIIIIIIIIIIIIIIIIIG+
+GGGGGGGGGGGGGGGGGGGGGGGGIHHHHHHHHHHHIIIIIIIHIIIIIIIIIIIIIGGGGGGGGGGGGGIGGGIIIIIIIIIIIIIIIIIHHHHHHHHHHHHHJJJJJJJJJHIIIIIIIIIIIIIIIIIIIIIIIIIG+
+GGGGGGGGGGGGGGGGGGGGGGGGIHHHHHHHHHHHIIIHHIIIIIIIIIIIIIIIIGGGGGGGGGGGGGGGGIGGIIIIIIIIIIIIIIIHHHHHHHHHHHHHHJJJJJJJJHIGGIIIIIIIIIIIIIIIIIIIIIIG+
+GGGGGGGGGGGGGGGGGGGGGGGGIIHHHHHHHHHHIIIHHIIIIIIIIIIIIIIIIIGGGGGGGGGGGIGGIGGGIIIIIIIIIIIIIIIIHHHHHHHHHHHHHHJJJJJHHHIIIIIIIIIIIIIIIIIIIIIIIIIG+
+GGGGGGGGGGGGGGGGGGGGGGGIIIHHHHHHHHHHIIHHIIIIIIIIIIIIIIIIIGGGGGGGGGGGGGGIIIIIIIIIIIIIIIIIIIIIHHHHHHHHHHHHHHJJJJJJHHGIIIIIIIIIIIIIIIIIIIIIIIIG+
+GGGGGGGGGGGGGGGGGGGGGGGIGIHHHHHHHHHHHHHHIIIIIIIIIIIIIIIIIIIIIIGGGGIGGGIIIGIIIIIIIIIIIIIIIIIIHHHHHHHHHHHHJJJJJJJJHHIGIIIIIIIIIIIIIIIIIIIIIIIG+
+GGGGGGGGGGGGGGGGGGGGGGGIIHHHHHHHHHHHIHHHHIIIIIIIIIIIIIIIIIGGGGGGGGGGGGIIGIIGIIIIIIIIIIIIIIIIHHHHHHHHHHHHHJJJJJJHHHIIGIIIIIIIIIIIIIIIIIIIIIIG+
+GGGGGGGGGGGGGGGGGGGGGGGGIIHHHHHHHHHHIHHHHIIIIIIIIIIIIIIIIIIGGGGGGGGGGGGGGIIGIIIIIIIIIIIIIIIIIHHHHHHHHHHHHJJJJJJJHHIIIIIIIIIIIIIIIIIIIIIIIIIG+
+GGGGGGGGGGGGGGGGGGGGGGGIGIHHHHHHHHHHHHHHIIIIIIIIIIIIIIIIIIIIGGGGGGGGGGGGGGGIIIIIIIIIIIIIIIIIIHHHHHHHHHHHHJJJJJJJHHIIIIIIIIIIIIIIIIIIIIIIIIIG+
+GGGGGGGGGGGGGGGGGGGGGGGGGIIHJHHHHHHHHHHHIIIIIIIIIIIIIIIIIGGIIIGGGGGGGGGGIGGIIIIIIIIIIIIIIIIHHHHHHHHHHHHHHJJJJJJJHHIIGIIIIIIIIIIIIIIIIIIIIIIG+
+GGGGGGGGGGGGGGGGGGGGGGGGGGHHHHHHHHHHHHHHHIIIIIIIIIIIIIIIIIGGGGGGGGGGGGGIIGGIIIIIIIIIIIIIIIIHHHHHHHHHHHHHJJJJJJJJJIGIIIIIIIIIIIIIIIIIIIIIIIIG+
+GGGGGGGGGGGGGGGGGGGGGGGGGIIHJHHHHHHHHHHHIIIIIIIIIIIIIIIIIIIIIIGGGGGGGGIGGIIIIIIIIIIIIIIIIIIIHHHHHHHHHHHHJJJJJJJJJHIGIIIIIIIIIIIIIIIIIIIIIIIG+
+GGGGGGGGGGGGGGGGGGGGGGGGGGIHJHHHHHHHHHHHHIIIIIIIIIIIIIIIIIIIIIIGGIGGIIGGIIIIIIIIIIIIIIIIIIIHHHHHHHHHHHHHJJJJJJJJHHIIIIIIIIIIIIIIIIIIIIIIIIIG+
+GGGGGGGGGGGGGGGGGGGGGGGGGGIHHHHHHHHHHHHHHIIIIIIIIIIIIIIIIIIIIGIIIIIIIIIIIIIIIIIIIIIIIIIIIIIHHHHHHHHHHHHHHJJJJJJJHIIIIIIIIIIIIIIIIIIIIIIIIIIG+
+GGGGGGGGGGGGGGGGGGGGGGGGGGIHHHHHHHHHHHHHHIIIIIIIIIIIIIIIIIIIIIIIIGIGGIIIIIIIIIIIIIIIIIIIIIHHHHHHHHHHHHHJHHJJJJJJHHIGIIIIIIIIIIIIIIIIIIIIIIIG+
+GGGGIGGGGGGGGGGGGGGGGGGGGGIHHHHHHHHHHHHHHIIIIIIIIIIIIIIIIIIIIIIGIIGGIIIIIIIIIIIIIIIIIIIIIHHHHHHHHHHHHHJJJJJJJJJJHIIIIIIIIIIIIIIIIIIIIIIIIIIG+
+GGIIIGGGGGGGGGGGGGGGGGGIGGIHHHHHHHHHHHHHHHIIIIIIIIIIIIIIIIIGGIIIIIIIIIGIIIIIIIIIIIIIIIIIIHHHHHHHHHHHHHJJJJJJJJJJHGGIIIIIIIIIIIIIIIIIIIIIIIIG+
+GGIIIGGGGGGGGGGGGGGGGGGGGGGHHHHHHHHHHHHHHIIIIIIIIIIIIIIIGIIGGIGIIGGIGGGIIGIGGIIIIIIIIIIIIIIHHHHHHHHHHHHJJHJJJJJJHGGIIIIIIIIIIIIIIIIIIIIIIIIG+
+GGIIIGGGGGGGGGGGGGGGGGIGIGGHHHHHHHHHHHHHHIIIIIIIIIIIIIIIGGGIIIGGIGIIGGIIIIIGIIIIIIIIIIIIIIIHHHHHHHHHHHHJJJJJJJJJHGGGIIIIIIIIIIIIIIIIIIIIIIIG+
+GGIIIGGGGGGGGGGGGGGGGGGGIGGHHHHHHHHHHHHHHIIIIIIIIIIIIIIIIIIIGGGGGGIIIGIIIIIIIIIIIIIIIIIIIIIIHHHHHHHHHHHJJJJJJJJJHIGIIIIIIIIIIIIIIIIIIIIIIIIG+
+GGIIIGGGGGGGGGGGGGGGGGIGIGIHHHHHHHHHHHHHHIIIIIIIIIIIIIIIIIIIIIIIIGGIIIIIGIIIIIIIIIIIIIIIIIIIHHHHHHHHHHHJJJJJJJJJHIGIIIIIIIIIIIIIIIIIIIIIIIIG+
+GGGGGGGGGGGGGGGGGGGGGGGGGGIHHHHHHHHHHHHHHIIIIIIIIIIIIIIIIIIIIIIIIIIIIIIIIIIIIIIIIIIIIIIIHHIHHHHHHHHHHHHHJJJJHJJJJIGGIIIIIIIIIIIIIIIIIIIIIIIG+
+GGGGGGGGGGGGGGGGGGGGGGGIGGIHHHHHHHHHHHHHIIIIIIIIIIIIIIIIIIIIIIIIIIIIIIIIIIIIIIIHIIIIIHHHHHHHHHHHHHHHHHHHJJJJHJJJJIGGIIIIIIIIIIIIIIIIIIIIIIIG+
+GGGGGGGGGGGGGGGGGGGGGGGGGGHHHHHHHHHHHHHIIIIIIIHIIIIIIIIIIIIIIIIIIIIIIIIIIIHHHHHHHHHHHHHHHHHHHHHHHHHHHHHHJJJJHHHJJHGGIIIIIIIIIIIIIIIIIIIIIIIG+
+GGGGGGGGGGGGGGGGGGGGGGGGGIHHHHHHHHHHHHHIIHHHHHHHHHHIHHHHHHIIIIIIIIIIIIIIHHHHHHHHHHHHHHHHHHHHHHHHHHHHHHHHJJJJJHHHJHGGIIIIIIIIIIIIIIIIIIIIIIIG+
+GGGGGGGGGGGGGGGGGGGGGGGIGIHHHHHHHHHHHHHHHHHHHHHHHHHHHHHHHHHHHHIIIIIIIIIHHHHHHJJJJHHHHHHHHHHHHHHHHHHHHHHHJJJJJJHHHHGGIIIIIIIIIIIIIIIIIIIIIIIG+
+GGGGGGGGGGGGGGGGGGGGGGGIGIHHHHHHHHHHHHHHHHHHHHHHHHHHHHHHHHHHHHIIIIIIIIHHHHHHHJJJJHHHHHHHHHHHHHHHHHHHHHHHJJJJJJHHHHIGIIIIIIIIIIIIIIIIIIIIIIIG+
+GGGGGGGGGGGGGGGGGGGGGGGGIIHHHHHHHHHIHHHHHHHHHHHHHHHHJHHHHHHHHHHIIIIIIIHHHHJHHHHHHHHHHHHHHHHHHHHHHHHHHHHHHJJJJHHHHHIGIIIIIIIIIIIIIIIIIIIIIIIG+
+GGGGGGGGGGGGGGGGGGGGGGGGIHHHHHHHHHHIHHHHHHHHHHHHHHHHHHHHHHHHHHHIIIIIIIIHHHHHHHHHHHHHHHHHHHHHHHHHHHHHHHHHHJJJJHHHHHHGIIIIIIIIIIIIIIIIIIIIIIIG+
+GGGGGGGGGGGGGGGGGGGGGGGGIHHHHHHHHHIHHHHHHHHHHHHHHHHHHHJJHHHHHHHIIIGIIIIHHHHHHHHJHHHHHHHHHHHHHHHHHHHHHHHHHJJJHHHHJJHIIIIIIIIIIIIIIIIIIIIIIIIG+
+GGGGGGGGGGGGGGGGGGGGGGGGIHHHHHHHHHHHHHHHHHHHHHHHHHHHHHHHHHHHHHHHIIIIIIIHHHHHHHHHHHJHHJJHHHHHHHHHHHHHHHHHHJHHHHHHJJHIGIIIIIIIIIIIIIIIIIIIIIIG+
+GGGGGGGGGGGGGGGGGGGGGGGGIHHHHHHHHHHHHHHHHHHHHHHHJJHHHJHHHHHHHHHHIIIIIIHHHHHHHHHHHHHHJJJJHHHHHHHHHHHHHHHHHHJHHHHHHHHIGIIIIIIIIIIIIIIIIIIIIIIG+
+GGGGGGGGGGGGGGGGGGGGGGGGIHHHHHHHHHHHHHHHHHHHHHHHHHJJHHHHHHHIHHHHIIIIIIHHHHHHHHHHIHHJJHHHHHHHHHHHHHHHHHHHHHJJHHHHHHHIGIIIIIIIIIIIIIIIIIIIIIIG+
+GGGGGGGGGGGGGGGGGGGGGGGGIHHHHHHHHHHHHHHHHHHHHHHHHHHJHHHIIHHHIHHIIIIIIIIHHHIIHHHIIHHHHHHHHHHHHHHHHHHHHHHHHHHJJHHHHHHIGIIIIIIIIIIIIIIIIIIIIIIG+
+GGGGGGGGGGGGGGGGGGGGGGGGIHHHHHHHHHIIHHHHHHHHHHHIHHHHHHIIIHHHIIHHIIIIIIIHHHIHHIHIIIHIHHHHHHHHHHHHHHHHHHHHHHHJHHHHHHHIGIIIIIIIIIIIIIIIIIIIIIIG+
+GGGGGGGGGGGGGGGGGGGGGGGGIHHHHHHHHHIIIIHHHHHHHHHHIHHIHIIIIIIIIHHHIIIIIIIHHHHIIIIIIIIIIHHHHHHHHHHHHHHHHHHHHHHHHHHHHHHIGIIIIIIIIIIIIIIIIIIIIIIG+
+GGGGGGGGGGGGGGGGGGGGGGGGIIHIHHHHHHHIIIIHIIIHHHHHHIIIIIIIIIIIHIIIIIIIIIIHHHHIIIIIIIHHHHHIHHHIIIIIHHHHHHHHHHHHHHHHHHHIIIIIIIIIIIIIIIIIIIIIIIIG+
+GGGGGGGGGGGGGGGGGGGGGGGGIIIIHHHHHIHIIIIIIIIIIIIIIIIIIIIIIIIIIIIIIIIIIIIHHHHHIIIIIIIIHHHHHHHIIIIIIIIIIHHHHHHHHHHHHHHIGIIIIIIIIIIIIIIIIIIIIIIG+
+GGGGGGGGGGGGGGGGGGGGGGGGIIIIHHHHHHIIIIIIIIIIIIIIIIIIIIIIIIIIIIIIIIIIIIIHHHHHIIIIIIIIIIIIIIIIIIIIIIIIIHHHHHHHHHHHHHHIGIIIIIIIIIIIIIIIIIIIIIIG+
+GGGGGGGGGGGGGGGGGGGGGGGGIIIIHHHHHIIIIIIIIIIIIIIIIIIIIIIIIIIIIIIIIIIIIIIHHHHHIIIIIIIIIIIIIIIIIIIIIIIIIHHHHHHHHHHHHIHIGIIIIIIIIIIIIIIIIIIIIIIG+
+GGGGGGGGGGGGGGGGGGGGGGGGIIIIHHHHHIIIIIIIIIIIIIIIIIIIIIIIIIIIIIIIIIIIIIIIHHHHIIIIIIIIIIIIIIIIIIIIIIIIIHHHHHHHHHHHHIHIIGIIIIIIIIIIIIIIIIIIIIIG+
+GGGGGGGGGGGGGGGGGGGGGGGGIIIIIHHHHIIIIIIIIIIIIIIIIIIIIIIIIIIIIIIIIIIIIIIIHHHHHIIIIIIIIIIIIIIIIIIIIIIIIHHHHHHHHHHHIIIIGIIIIIIIIIIIIIIIIIIIIIIG+
+GGGGGGGGGGGGGGGGGGGGGGGGIIIIIIHHHIIIIIIIIIIIIIIIIIIIIIIIIIIIIIIIIIIIIIIIHHHHHIIIIIIIIIIIIIIIIIIIIIIIIHHHHHHHHHHHIIIIGIIIIIIIIIIIIIIIIIIIIIIG+
+GGGGGGGGGGGGGGGGGGGGGGGGGIIIIIIIHIIIIIIIIIIIIIIIIIIIIIIIIIIIIIIIIIIIIIIIHHHHIIIIIIIIIIIIIIIIIIIIIIIIHHHHHHHHHHHHHIIIGIIIIIIIIIIIIIIIIIIIIIIG+
+GGGGGGGGGGGGGGGGGGGGGGGGGIIIIIIHHIIIIIIIIIIIIIIIIIIIIIIIIIIIIIIIIIIIIIIIHHHHIIIIIIIIIIIIIIIIIIIIIIIIIHHHHHHHHHHHHIHIIIIIIIIIIIIIIIIIIIIIIIIG+
+GGGGGGGGGGGGGGGGGGGGGGGGGIHIIIIHHIIIIIIIIIIIIIIIIIIIIIIIIIIIIIIIIIIIIIIIHHHHHHIIIIIIIIIIIIIIIIIIIIIIIHHHHHHHHHHHIHHIIIIIIIIIIIIIIIIIIIIIIIIG+
+GGGGGGGGGGGGGGGGGGGGGGGGGGIHIIIHHIIIIIIIIIIIIIIIIIIIIIIIIIIIIIIIIIIIIIIIHHHHHHIIIIIIIIIIIIIIIIIIIIIIHHHHHHHHHHIHHHHGIIIIIIIIIIIIIIIIIIIIIIIG+
+GGGGGGGGGGGGGGGGGGGGGGGGGGIHIIIIHHIIIIIIIIGGGIIIIIIGIIIIIIIIIIIIIIIIIIIIHHHIIHIIIIIIIIIIIIIIIIIIIIIIHHHHHHHHHHIIHHHGIIIIIIIIIIIIIIIIIIIIIIIG+
+GGGGGGGGGGGGGGGGGGGGGGGGGGIIIIIIHHIIIIIIIIIIIIIIIIIIIIIIIIHIIIIIIIIIGGIIHHIIIHHHHIIIIIIIIIIIIIIIIIIIHHHHHHHHHHHHHHIIGIIIIIIIIIIIIIIIIIIIIIIG+
+GGGGGGGGGGGGGGGGGGGGGGGGGGIIIIIHHHHHIIIIIIIIIIIIIIIIIIIIIIIIIIIIIIIIGGGIHHIIIIIHHHIIIIIIIIIIIIIIIIIIHHHHHHHHHHHHHHIIIGIIIIIIIIIIIIIIIIIIIIIG+
+GGGGGGGGGGGGGGGGGGGGGGGGGGGIIIIHHHHHIIIIIIIIIIIIIIGIIIIIIIIIIIIIIIIIGGGIHHIIIIIHHHHHIIIIIIIIIIIIIIHHHHHHHHHHHHHHHIGIIIIIIIIIIIIIIIIIIIIIIIIG+
+GGGGGGGGGGGGGGGGGGGGGGGGGGGIIIIIHHHHIIIIIIIIIIIIIIIIIIIIHIIIIIIIIIIIIIIIHHHIIHIHHHHHHIIIIIIIIIIIIIHHHHHHHHHHHHHHHIGIIIIIIIIIIIIIIIIIIIIIIIIG+
+GGGGGGGGGGGGGGGGGGGGGGGGGGGIHIIIIHHHIIIIIIIIIIIIIIIIIIIIHIIIIIHHHIIIIIIIHHHHHHHHHIHHHHIIIIIIIIIIIHHHHHHHHHHHHHHHHIIIIIIIIIIIIIIIIIIIIIIIIIIG+
+GGGGGGGGGGGGGGGGGGGGGGGGGGGGIIIIIHHHHIIIIIIIIIIIIIIIIIIIIHHHHJHHHHIIIIIHHHHJJHHHHIIHHHHIIIIIIIIHHHHHHHHHHHHHHHHHIGIIIIIIIIIIIIIIIIIIIIIIIIIG+
+GGGGGGGGGGGGGGGGGGGGGGGGGGGGIHIIIHHHHHIIIIIIIIIIIIIIIIIIIHHHJJJJHHHHHHHHHJJJJJJHHIIIIHHHHHHHIHHHHHHHHHHHHHHHHHHHIGIIIIIIIIIIIIIIIIIIIIIIIIIG+
+GGGGGGGGGGGGGGGGGGGGGGGGGGGGGIHIIHHHHHIIIIIIIIIIIIHHIIIIIHHHHHHHHHHHHHHHJJJJJJHHHHIIIIHHHHHHHHHHHHHHHHHHHHHHHHHIGIIIIIIIIIIIIIIIIIIIIIIIIIIG+
+GGGGGGGGGGGGGGGGGGGGGGGIIGGGGIHHHHHHHHHHIIIIIIIIIHHHIIIIIIHHHHHHHHHHHHHJJJHHHHHHHHIIIIIHHHHHHHHHHHHHHHHHHHHHHHHIGIGIIIIIIIIIIIIIIIIIIIIIIIIG+
+GGGGGGGGGGGGGGGGGGGGGGGGGGGGGGIHHHHHHHHHHHIIIIIHHHIIIIIIIIHHHHHHHHHHHJJJJHHHHHHHHHIIIIIIHHHHHHHHHHHHHHHHHHHHHHIGIIIIIIIIIIIIIIIIIIIIIIIIIIIG+
+GGGGGGGGGGGGGGGGGGGGGGGGGGGGGGGIIHHHHHHHHHHIIIHHHIIIIIIIIIIIHHHHHHHHJJJJHHHHHHHHHIHIIIIIIHHHHHHHHHHHHHHHHIIIIGIIIIIIIIIIIIIIIIIIIIIIIIIIIIIG+
+GGGGGGGGGGGGGGGGGGGGGGGGGGGGGIIGGIHHHHHHHHHHHHHHIIIIIIIIIIIIHHHHHHHHHJJHHHHHHHHHHHHHHHHHIIHHHHHHHHHHHHHHHIGGGIIIIIIIIIIIIIIIIIIIIIIIIIIIIIIG+
+GGGGGGGGGGGGGGGGGGGGGGGGGGGGIGGGGIHHHHHHHHHHHHHIIIIIIIIIIIIIIIIHHHHHHHHHHHHHHHIHHHHHHHHHHHHHHHHHHHHHHHHHHIGIIIIIIIIIIIIIIIIIIIIIIIIIIIIIIIIG+
+GGGGGGGGGGGGGGGGGGGGGGGGGGGGGGIIGIHHHHHHHHHHHIIIIIIIIIIIIIIIIIIIIHHHHHHHHHHHHIHHHHHHHHHHHHHHHHHHHHHHHHHHHIGIIIIIIIIIIIIIIIIIIIIIIIIIIIIIIIIG+
+GGGGGGGGGGGIIIIIIGGGGGGGGGGGIIGGGIHHHHHHHHHHHHIIIIIIIIIIIIIIIIIIIHHHHHHHHHHHHHHHHHHHHHHHIIHHHHHHHHHHHHHHHIIIIIIIIIIIIIIIIIIIIIIIIIIIIIIIIIIG+
+GGIIGGGGGGGIIIIIIGGGGGGGGGGGGIIIGIHHHHHHHHIHHHIIIIHHIIIIIIIIIIIIIIIHHIHIIIHHHHHHHHHHHHHHIHHHHHHHHHHHHHHHHIIIIIIIIIIIIIIIIIIIIIIIIIIIIIIIIIIG+
+GGIIGGGGGGGIIIIIIGGGGGGGGGGGIIIIGIHHHHHIHIIIHIIIIIHHHIIIIIIIIIIIIIIIIIIIIIIIIIIHHHHHHHHHHHHHHHHHHHHHHHHHHIIIIIIIIIIIIIIIIIIIIIIIIIIIIIIIIIIG+
+GGIIGGGGGGGIIIIIIIIIIIIIIIIIIIIIGGIHHHHIIIIIIHIIIIHHHHHIIIIIIIIIIIIIIIIIIHHIIIIHHHHHHHHIHHHHHHHHHHHHHHHHHGIIIIIIIIIIIIIIIIIIIIIIIIIIIIIIIIIG+
+GGIIGGGGGGGIIIIIIIIIIIIIIIIIIIIIGGIHHIIIIIIIIHHIIIHHHHHIIIIIIIIHHHHIIIIHHHHHHHHHHHHHJHHIIHHHHIHHHHHHHHHHIIIIIIIIIIIIIIIIIIIIIIIIIIIIIIIIIIIG+
+GGIIGGGGGGGIIIIIIIIIIIIIIIIIIIIIIGIHHIIHIIIIIIHIIIIHHHHHHHHHHHHHHHHHHHHHHHHHHHJJJJJJHHIIIHHHIIHHHHHHHHHHIGIIIIIIIIIIIIIIIIIIIIIIIIIIIIIIIIIG+
+GGIIGGIIIIIIIIIIIIIIIIIIIIIIIIIIIGIHHHIHHIIIIIIHIIIIHHHHHHHHHHHHHHHHHHHHHHHHHHHHHHHHIIIIIHHHHIHHHHHHHHHHIIIIIIIIIIIIIIIIIIIIIIIIIIIIIIIIIIIG+
+GGIIGGIIIIIIIIIIIIIIIIIIIIIIIIIIIGIHHHIIHHIIIIIHHIIIIIHHHHHHHHHHHHHHHHHHHHHHHHHHHHHHHIIIHHHHIHHHHHHHHHHHGIIIIIIIIIIIIIIIIIIIIIIIIIIIIIIIIIIG+
+GGIIIGIIIIIIIIIIIIIIIIIIIIIIIIIIIIGHHHHHHHHIIIIIIIIIIIIIHHHIIIIIIIHHHHIHIIIIIHHHHHHHHIIIHHHHHHHHHHHHHHHIGIIIIIIIIIIIIIIIIIIIIIIIIIIIIIIIIIIG+
+GGIIIIIIIIIIIIIIIIIIIIIIIIIIIIIIIIGIHHHHHHHHIIIIIIIIIIHHHHHIIIIIIIIIIIIIIIIIHHHHHHHHIIIHHHHHHHHHHHHHHHHIIIIIIIIIIIIIIIIIIIIIIIIIIIIIIIIIIIIG+
+GGIIIIIIIIIIIIIIIIIIIIIIIIIIIIIIIIIIHHHHIHHHHIIIIIIIIIIHHHIHHIIIIGGGGIIIIIIHHHHHHHHIIIIHHHHHHHHHHHHHHHHIIIIIIIIIIIIIIIIIIIIIIIIIIIIIIIIIIIIG+
+GGIIIIIIIIIIIIIIIIIIIIIIIIIIIIIIIIIIHHHHHHHHHHHHIIIIIIIHHHHHHHHHIIIIIIIIIIHHHHHHHHHIIIIIHHHHHHHHHHHHHHHGIIIIIIIIIIIIIIIIIIIIIIIIIIIIIIIIIIIG+
+GGIIIIIIIIIIIIIIIIIIIIIIIIIIIIIIIIIGIHHHHHHHHHHIIIIIIIIIHHHHHHHHHIIIIIIIHHHHHHHHHHHIIIIHHHHHHHHHHHHHHHIIIIIIIIIIIIIIIIIIIIIIIIIIIIIIIIIIIIIG+
+GGIIIIIIIIIIIIIIIIIIIIIIIIIIIIIIIIIIIHHHHHHHHHIIHIIIIIIIHHHHHHHHHHHHHHHHHHHHHHHHHHHHHHHHHHHHHHHHHHHHJHGIIIIIIIIIIIIIIIIIIIIIIIIIIIIIIIIIIIIG+
+GGIIIIIIIIIIIIIIIIIIIIIIIIIIIIIIIIIIIIHHHHHHHHHHHHIIIIIIIHHHHHHHHHHHHHHHHHHHHHHHHHHHHHHHHHHHHHHHHHHHHIIIIIIIIIIIIIIIIIIIIIIIIIIIIIIIIIIIIIIG+
+GGIIIIIIIIIIIIIIIIIIIIIIIIIIIIIIIIIIIIHHHHHHHHHHIHIIIIIIIHHHHHHHHHHHHHJJJJJHHHHHHHHHHHHHHHHHHHHHHHHHHGIIIIIIIIIIIIIIIIIIIIIIIIIIIIIIIIIIIIIG+
+GGIIIIIIIIIIIIIIIIIIIIIIIIIIIIIIIIIIIGIHHHHHHHHHHHIIIIIIIHHHHHHHHHHHHHHHHHHHHHHHHHIHHHHHHHHHHHHHHHHHIGIIIIIIIIIIIIIIIIIIIIIIIIIIIIIIIIIIIIIG+
+GGIIIIIIIIIIIIIIIIIIIIIIIIIIIIIIIIIIIIIHHHHHHHHHHHHIIIIIIIHHHHHHHHHHHHHHHHHHHHHHHHIHHHHHHHHHHHHHHHJHIIIIIIIIIIIIIIIIIIIIIIIIIIIIIIIIIIIIIIII+
+IGIIIIIIIIIIIIIIIIIIIIIIIIIIIIIIIIIIIIIIHHHHHHHHHHHIIIIIIIIIIHHHHHHHHHHHHHHHHHHHIIIHHHHHHHHHHHHHHHJHIIIIIIIIIIIIIIIIIIIIIIIIIIIIIIIIIIIIIIII+
+IGIIIIIIIIIIIIIIIIIIIIIIIIIIIIIIIIIIIIIGIHHHHHHHHHHIIIIIIIIIIIIIHHHHHHHHHHHHIIHIIIIHHHHHHHHHHHHHHJJHIIIIIIIIIIIIIIIIIIIIIIIIIIIIIIIIIIIIIIII+
+IGIIIIIIIIIIIIIIIIIIIIIIIIIIIIIIIIIIIIIIIHHHHHHHHHHIIIIIIIIIIIIIIIIIIIIIIIIIIIIIIIIIHHHHHHHHHHHHJJJHIIIIIIIIIIIIIIIIIIIIIIIIIIIIIIIIIIIIIIII+
+IGIIIIIIIIIIIIIIIIIIIIIIIIIIIIIIIIIIIIIIIHHHHHHHHHHIIIIIIIIIIIIIIIIIIIIIIIIIIIIIIIHHHHHHHHHHHHHJJJJHIIIIIIIIIIIIIIIIIIIIIIIIIIIIIIIIIIIIIIII+
+IGIIIIIIIIIIIIIIIIIIIIIIIIIIIIIIIIIIIIIIHHHHHHHHHHHHIIIIIIIIIIIIIIIIIIIIIIIIIIIIIHHHHHHHHHHHHJJJJJHHHIIIIIIIIIIIIIIIIIIIIIIIIIIIIIIIIIIIIIII+
+GGIIIIIIIIIIIIIIIIIIIIIIIIIIIIIIIIIIIIGHJHHHHHHHHHHHHHIIIIIIIIIIIIIIIIIIIIIIIIIIHHIHHHHHHHHHJJJJJJHHJHIIIIIIIIIIIIIIIIIIIIIIIIIIIIIIIIIIIIII+
+IGIIIIIIIIIIIIIIIIIIIIIIIIIIIIIIIIIIIIIHJHHHHHHHHHHHHHIIIIIIIIIIIIIIIIIIIIIIIIIHHHHHHHHHHHJJJJJJJJHHJJHIIIIIIIIIIIIIIIIIIIIIIIIIIIIIIIIIIIII+
+IGIIIIIIIIIIIIIIIIIIIIIIIIIIIIIIIIIIIIHJJJHHHHHHHHHHHHIIIIIIIIIIIIIIIIIIIIIIIIIHHHHHHHHHHJJJJJJJJJHHJJJHIIIIIIIIIIIIIIIIIIIIIIIIIIIIIIIIIIII+
+IGIIIIIIIIIIIIIIIIIIIIIIIIIIIIIIIIIIGHJJJJHHHHHHHHHHHHHIIIIIIIIIIIIIIIIIIIIIIHHHHHHHHHHHJJJJJJJJJHHHJJJJHIIIIIIIIIIIIIIIIIIIIIIIIIIIIIIIIIII+
+IGIIIIIIIIIIIIIIIIIIIIIIIIIIIIIIIIIIHJJJJJHHHHHHHHHHHHHHIIIHIIIIIHIIIIIIIIIIHHHHHHHHHHJJJJJJJJJJJHHJJJJJJHIIIIIIIIIIIIIIIIIIIIIIIIIIIIIIIIII+
+GGIIIIIIIIIIIIIIIIIIIIIIIIIIIIIIIIIHJJJJJJHHHHHHHHHHHHHHHHHHHIIIIHIIHHIIHHHHHHHHHHHHHJJJJJJJJJJJHHHJJJJJJJHIIIIIIIIIIIIIIIIIIIIIIIIIIIIIIIII+
+IGIIIIIIIIIIIIIIIIIIIIIIIIIIIIIIIIHJJJJJJJHHHHHHHHHHHHHHHHHHHHHHHHHHHHHHHHHHHHHHHHHHJJJJJJJJJJJJJHHJJJJJJJJHIIIIIIIIIIIIIIIIIIIIIIIIIIIIIIII+
+IGIIIIIIIIIIIIIIIIIIIIIIIIIIIIIGIHJJJJJJJJHHHHHHHHHHHHHHHHHHHHHHHHHHHHHHHHHHHHHHHHHJJJJJJJJJJJJJHHHJJJJJJJJJHIIIIIIIIIIIIIIIIIIIIIIIIIIIIIII+
+IGIIIIIIIIIIIIIIIIIIIIIIIIIIIIGIHJJJJJJJJJHHHHHHHHHHHHHHHHHHHHHHHHHHHHHHHHHHHHHHHJJJJJJJJJJJJJHHHHHJJJJJJJJJJHHIIIIIIIIIIIIIIIIIIIIIIIIIIIII+
+IGIIIIIIIIIIIIIIIIIIIIIIIIIIIIIHJJJJJJJJJJHHHHHHHHHHHHHHHHHHHHHHHHHHHHHHHHHHHHHJJJJJJJJJJJJJJJHHHHHJJJJJJJJJJJJHIIIIIIIIIIIIIIIIIIIIIIIIIIII+
+IGIIIIIIIIIIIIIIIIIIIIIIIIIIIHHJJJJJJJJJJJHHHHHHHHHHHHHHHHJJHHHHHHHHHHHHHJJJJJJJJJJJJJJJJJJJJHHHHHHJJJJJJJJJJJJJHHIIIIIIIIIIIIIIIIIIIIIIIIII+
+GGIIIIIIIIIIIIIIIIIIIIGIIIHHHJJJJJJJJJJJJJHHHHHHHHHHHHHHHHHHJJJJJJJJJJJJJJJJJJJJJJJJJJJJJJJJJHHHHHHJJJJJJJJJJJJJJJJHHHIIIIIIIIIIIIIIIIIIIIII+
+IGIIIIIIIIIIIIIIIIIGIIIHHHJJJJJJJJJJJJJJJJHHHHHHHHHHHHHHHHHHHJJJJJJJJJJJJJJJJJJJJJJJJJJJJJJJJHHHHHHJJJJJJJJJJJJJJJJJJJHHHIIIIIIIIIIIIIIIIIII+
+IGIIIIIIIIIIIIIIIIIIHHHJJJJJJJJJJJJJJJJJJJHHHHHHHHHHHHHHHHHHHHJJJJJJJJJJJJJJJJJJJJJJJJJJJJJJHHHHHHHJJJJJJJJJJJJJJJJJJJJJJHHHIIIIIIIIIIIIIIII+
+IGIIIIIIIIIIIIIIIHHHJJJJJJJJJJJJJJJJJJJJJJHHHHHHHHHHHHHHHHHHHHHHJJJJJJJJJJJJJJJJJJJJJJJJJJHHHHHHHHHHJJJJJJJJJJJJJJJJJJJJJJJJHHHIIIIIIIIIIIII+
+IGIIIIIIIIIIIIHHHJJJJJJJJJJJJJJJJJJJJJJJJJHHHHHHHHHHHHHHHHHHHHHHHJJJJJJJJJJJJJJJJJJJJJJJJJHHHHHHHHHHJJJJJJJJJJJJJJJJJJJJJJJJJJJHHHIIIIIIIIII+
+IGIIGIIIIIIHHHJJJJJJJJJJJJJJJJJJJJJJJJJJJJHHHHHHHHHHHHHHHHHHHHHHHHJJJJJJJJJJJJJJJJJJJJJJHHHHHHHHHHHHJJJJJJJJJJJJJJJJJJJJJJJJJJJJJJHHHIIIIIII+
+GGIIIIHHHHJJJJJJJJJJJJJJJJJJJJJJJJJJJJJJJJHHHHHHHHHHHHHHHHHHHHHHHHHJJJJJJJJJJJJJJJJJJJJJHHHHHHHHHHHHJJJJJJJJJJJJJJJJJJJJJJJJJJJJJJJJJHHHIIII+
+IIHHHJJJJJJJJJJJJJJJJJJJJJJJJJJJJJJJJJJJJHHHHHHHHHHHHHHHHHHHHHHHHHHJJJJJJJJJJJJJJJJJJJJHHHHHHHHHHHHHJJJJJJJJJJJJJJJJJJJJJJJJJJJJJJJJJJJJHHHI+
+HHJJJJJJJJJJJJJJJJJJJJJJJJJJJJJJJJJJJJJJJHHHHHHHHHHHHHHHHHHHHHHHHHHHJJJJJJJJJJJJJJJJJJJHHHHHHHHHHHHHJJJJJJJJJJJJJJJJJJJJJJJJJJJJJJJJJJJJJJJH+
+JJJJJJJJJJJJJJJJJJJJJJJJJJJJJJJJJJJJJJJJJHHHHHHHHHHHHHHHHHHHHHHHHHHHHJJJJJJJJJJJJJJJJJHHHHHHHHHHHHHHJJJJJJJJJJJJJJJJJJJJJJJJJJJJJJJJJJJJJJJJ+
+JJJJJJJJJJJJJJJJJJJJJJJJJJJJJJJJJJJJJJJJJHHHHHHHHHHHHHHHHHHHHHHHHHHHHHHJJJJJJJJJJJJJJHHHHHHHHHHHHHHHHJJJJJJJJJJJJJJJJJJJJJJJJJJJJJJJJJJJJJJJ+
+JJJJJJJJJJJJJJJJJJJJJJJJJJJJJJJJJJJJJJJJJHHHHHHHHHHHHHHHHHHHHHHHHHHHHHHHHJJJJJJJJJJJJHHHHHHHHHHHHHHHHJJJJJJJJJJJJJJJJJJJJJJJJJJJJJJJJJJJJJJJ+
+JJJJJJJJJJJJJJJJJJJJJJJJJJJJJJJJJJJJJJJJJHHHHHHHHHHHHHHHHHHHHHHHHHHHHHHHHJJJJJJJJHHHHHHHHHHHHHHHHHHHHJJJJJJJJJJJJJJJJJJJJJJJJJJJJJJJJJJJJJJJ+
+JJJJJJJJJJJJJJJJJJJJJJJJJJJJJJJJJJJJJJJJJHHHHHHHHHHHHHHHHHHHHHHHHHHHHHHHHJJJJHHHHHHHHHHHHHHHHHHHHHHHHJJJJJJJJJJJJJJJJJJJJJJJJJJJJJJJJJJJJJJJ+
+JJJJJJJJJJJJJJJJJJJJJJJJJJJJJJJJJJJJJJJJJHHHHHHHHHHHHHHHHHHHHHHHHHHHHHHHHHHHHHHHHHHHHHHHHHHHHHHHHHHHHJJJJJJJJJJJJJJJJJJJJJJJJJJJJJJJJJJJJJJJ+
+JJJJJJJJJJJJJJJJJJJJJJJJJJJJJJJJJJJJJJJJJHHHHHHHHHHHHHHHHHHHHHHHHHHHHHHHHHHHHHHHHHHHHHHHHHHHHHHHHHHHHJJJJJJJJJJJJJJJJJJJJJJJJJJJJJJJJJJJJJJJ+
+JJJJJJJJJJJJJJJJJJJJJJJJJJJJJJJJJJJJJJJJJHHIHHHHHHHHHHHHHHHHHHHHHHHHHHHHHHHHHHHHHHHHHHHHHHHHHHHHHHHHHJJJJJJJJJJJJJJJJJJJJJJJJJJJJJJJJJJJJJJJ+
+JJJJJJJJJJJJJJJJJJJJJJJJJJJJJJJJJJJJJJJJJHIIHHHHHHHHHHHHHHHHHHHHHHHHHHHHHHHHHHHHHHHHHHHHHHHHHHHHHHHHJJJJJJJJJJJJJJJJJJJJJJJJJJJJJJJJJJJJJJJJ+
+JJJJJJJJJJJJJJJJJJJJJJJJJJJJJJJJJJJJJJJJJJHIIHHHHHHHHHHHHHHHHHHHHHHHHHHHHHHHHHHHHHHHHHHHHHHHHHHHHHHHJJJJJJJJJJJJJJJJJJJJJJJJJJJJJJJJJJJJJJJJ+
+JJJJJJJJJJJJJJJJJJJJJJJJJJJJJJJJJJJJJJJJJJHIIHHHHHHHHHHHHHHHHHHHHHHHHHHHHHHHHHHHHHHHHHHHHHHHHHHHHHHHJJJJJJJJJJJJJJJJJJJJJJJJJJJJJJJJJJJJJJJJ+
+JJJJJJJJJJJJJJJJJJJJJJJJJJJJJJJJJJJJJJJJJJJHIIHHHHHHHHHHHHHHHHHHHHHHHHHHHHHHHHHHHHHHHHHHHHHHHHHHHHIHJJJJJJJJJJJJJJJJJJJJJJJJJJJJJJJJJJJJJJJJ+
+JJJJJJJJJJJJJJJJJJJJJJJJJJJJJJJJJJJJJJJJJJJJHIIHHHHHHHHHHHHHHHHHHHHHHHHHHHHHHHHHHHHHHHHHHHHHHHHHHHHJJJJJJJJJJJJJJJJJJJJJJJJJJJJJJJJJJJJJJJJJ+
+JJJJJJJJJJJJJJJJJJJJJJJJJJJJJJJJJJJJJJJJJJJJJHHIHHHHHHHHHHHHHHHHHHHHHHHHHHHHHHHHHHHHHHHHHHHHHHHHHHHJJJJJJJJJJJJJJJJJJJJJJJJJJJJJJJJJJJJJJJJJ+
+JJJJJJJJJJJJJJJJJJJJJJJJJJJJJJJJJJJJJJJJJJJJJJHHHHHHHHHHHHHHHHHHHHHHHHHHHHHHHHHHHHHHHHHHHHHHHHHIIHJJJJJJJJJJJJJJJJJJJJJJJJJJJJJJJJJJJJJJJJJJ+
+JJJJJJJJJJJJJJJJJJJJJJJJJJJJJJJJJJJJJJJJJJJJJJJJHIHHHHHHHHHHHHHHHHHHHHHHHHHHHHHHHHHHHHHHHHHHHHIIHJJJJJJJJJJJJJJJJJJJJJJJJJJJJJJJJJJJJJJJJJJJ+
+JJJJJJJJJJJJJJJJJJJJJJJJJJJJJJJJJJJJJJJJJJJJJJJJJHIHHHHHHHHHHHHHHHHHHHHHHHHHHHHHHHHHHHHHHHHHHIIHJJJJJJJJJJJJJJJJJJJJJJJJJJJJJJJJJJJJJJJJJJJJ+
+JJJJJJJJJJJJJJJJJJJJJJJJJJJJJJJJJJJJJJJJJJJJJJJJJJHHIHHHHHHHHHHHHHHHHHHHHHHHHHHHHHHHHHHHHHHHIIHJJJJJJJJJJJJJJJJJJJJJJJJJJJJJJJJJJJJJJJJJJJJJ+
+JJJJJJJJJJJJJJJJJJJJJJJJJJJJJJJJJJJJJJJJJJJJJJJJJJJHHIHHHHHHHHHHHHHHHHHHHHHHHHHHHHHHHHHHHHIIHHJJJJJJJJJJJJJJJJJJJJJJJJJJJJJJJJJJJJJJJJJJJJJJ+
+JJJJJJJJJJJJJJJJJJJJJJJJJJJJJJJJJJJJJJJJJJJJJJJJJJJJJHIHHHHHHHHHHHHHHHHHHHHHHHHHHHHHHHHHHIIHJJJJJJJJJJJJJJJJJJJJJJJJJJJJJJJJJJJJJJJJJJJJJJJJ+
+JJJJJJJJJJJJJJJJJJJJJJJJJJJJJJJJJJJJJJJJJJJJJJJJJJJJJJHHHHHHHHHHHHHHHHHHHHHHHHHHHHHHHHHHIIHJJJJJJJJJJJJJJJJJJJJJJJJJJJJJJJJJJJJJJJJJJJJJJJJJ+
+JJJJJJJJJJJJJJJJJJJJJJJJJJJJJJJJJJJJJJJJJJJJJJJJJJJJJJJJHHHHIIIIHHHHHHHHHHHHHHHHHIIHHHIIHJJJJJJJJJJJJJJJJJJJJJJJJJJJJJJJJJJJJJJJJJJJJJJJJJJJ+
+JJJJJJJJJJJJJJJJJJJJJJJJJJJJJJJJJJJJJJJJJJJJJJJJJJJJJJJJJHHIIIIIHHHHHHHHHHHHHHHIIIIIIHHHJJJJJJJJJJJJJJJJJJJJJJJJJJJJJJJJJJJJJJJJJJJJJJJJJJJJ+
+JJJJJJJJJJJJJJJJJJJJJJJJJJJJJJJJJJJJJJJJJJJJJJJJJJJJJJJJJJJHHIIIIIHHHHHHHHHHHHIIIIIIHHJJJJJJJJJJJJJJJJJJJJJJJJJJJJJJJJJJJJJJJJJJJJJJJJJJJJJJ+
+JJJJJJJJJJJJJJJJJJJJJJJJJJJJJJJJJJJJJJJJJJJJJJJJJJJJJJJJJJJJJHHIIIIIHHIIIIIIIIIIIIHHJJJJJJJJJJJJJJJJJJJJJJJJJJJJJJJJJJJJJJJJJJJJJJJJJJJJJJJJ+
+JJJJJJJJJJJJJJJJJJJJJJJJJJJJJJJJJJJJJJJJJJJJJJJJJJJJJJJJJJJJJJJHHIIIIIIIIIIIIIIHHJJJJJJJJJJJJJJJJJJJJJJJJJJJJJJJJJJJJJJJJJJJJJJJJJJJJJJJJJJJ+
+JJJJJJJJJJJJJJJJJJJJJJJJJJJJJJJJJJJJJJJJJJJJJJJJJJJJJJJJJJJJJJJJJHHHIIIIIIIIHHJJJJJJJJJJJJJJJJJJJJJJJJJJJJJJJJJJJJJJJJJJJJJJJJJJJJJJJJJJJJJJ+
+JJJJJJJJJJJJJJJJJJJJJJJJJJJJJJJJJJJJJJJJJJJJJJJJJJJJJJJJJJJJJJJJJJJJJHHHHHJJJJJJJJJJJJJJJJJJJJJJJJJJJJJJJJJJJJJJJJJJJJJJJJJJJJJJJJJJJJJJJJJJ+
+JJJJJJJJJJJJJJJJJJJJJJJJJJJJJJJJJJJJJJJJJJJJJJJJJJJJJJJJJJJJJJJJJJJJJJJJJJJJJJJJJJJJJJJJJJJJJJJJJJJJJJJJJJJJJJJJJJJJJJJJJJJJJJJJJJJJJJJJJJJJ+
+JJJJJJJJJJJJJJJJJJJJJJJJJJJJJJJJJJJJJJJJJJJJJJJJJJJJJJJJJJJJJJJJJJJJJJJJJJJJJJJJJJJJJJJJJJJJJJJJJJJJJJJJJJJJJJJJJJJJJJJJJJJJJJJJJJJJJJJJJJJJ+
+JJJJJJJJJJJJJJJJJJJJJJJJJJJJJJJJJJJJJJJJJJJJJJJJJJJJJJJJJJJJJJJJJJJJJJJJJJJJJJJJJJJJJJJJJJJJJJJJJJJJJJJJJJJJJJJJJJJJJJJJJJJJJJJJJJJJJJJJJJJJ+
+JJJJJJJJJJJJJJJJJJJJJJJJJJJJJJJJJJJJJJJJJJJJJJJJJJJJJJJJJJJJJJJJJJJJJJJJJJJJJJJJJJJJJJJJJJJJJJJJJJJJJJJJJJJJJJJJJJJJJJJJJJJJJJJJJJJJJJJJJJJJ+
+JJJJJJJJJJJJJJJJJJJJJJJJJJJJJJJJJJJJJJJJJJJJJJJJJJJJJJJJJJJJJJJJJJJJJJJJJJJJJJJJJJJJJJJJJJJJJJJJJJJJJJJJJJJJJJJJJJJJJJJJJJJJJJJJJJJJJJJJJJJJ+
+JJJJJJJJJJJJJJJJJJJJJJJJJJJJJJJJJJJJJJJJJJJJJJJJJJJJJJJJJJJJJJJJJJJJJJJJJJJJJJJJJJJJJJJJJJJJJJJJJJJJJJJJJJJJJJJJJJJJJJJJJJJJJJJJJJJJJJJJJJJJ+
+JJJJJJJJJJJJJJJJJJJJJJJJJJJJJJJJJJJJJJJJJJJJJJJJJJJJJJJJJJJJJJJJJJJJJJJJJJJJJJJJJJJJJJJJJJJJJJJJJJJJJJJJJJJJJJJJJJJJJJJJJJJJJJJJJJJJJJJJJJJJ+
+JJJJJJJJJJJJJJJJJJJJJJJJJJJJJJJJJJJJJJJJJJJJJJJJJJJJJJJJJJJJJJJJJJJJJJJJJJJJJJJJJJJJJJJJJJJJJJJJJJJJJJJJJJJJJJJJJJJJJJJJJJJJJJJJJJJJJJJJJJJJ+
+JJJJJJJJJJJJJJJJJJJJJJJJJJJJJJJJJJJJJJJJJJJJJJJJJJJJJJJJJJJJJJJJJJJJJJJJJJJJJJJJJJJJJJJJJJJJJJJJJJJJJJJJJJJJJJJJJJJJJJJJJJJJJJJJJJJJJJJJJJJJ+
++++++++++++++++++++++++++++++++++++++++++++++++++++++++++++++++++++++++++++++++++++++++++++++++++++++++++++++++++++++++++++++++++++++++++++++