#domain
hospital
#levelname
photo_black
#colors
green: 0
lightblue: F, G
grey: Z, E
orange: U, V, S, R, Q, X, Y, W
brown: T, P
blue: L, K, I, J, M, N, O, H
#initial
++++++++++++++++++++++++++++++++++++++++++++++++++++++++++++++++++++++++++++++++++++++++++++++++++++++
+0ZZZZZZZZZZZZZZZZZZZZZZZZZZZZZZZZZZZZZZZZZZZZZZZZZZZZZZZZZZZZZZZZZZZZZZZZZZZZZZZZZZZZZZZZZZZZZZZZZZZ+
+ZZZZZZZZZZZZZZZZZZZZZZZZZZZZZZZZZZZZZZZZZZZZZZZZZZZZZZZZZZZZZZZZZZZZZZZZZZZZZZZZZZZZZZZZZZZZZZZZZZZZ+
+ZZZZZZZZZZZZZZZZZZZZZZZZZZZZZZZZZZZZZZZZZZZZZZZZZZZZZZZZZZZZZZZZZZZZZZZZZZZZZZZZZZZZZZZZZZZZZZZZZZZZ+
+ZZZZZZZZZZZZZZZZZZZZZZZZZZZZZZZZZZZZZZZZZZZZZZZZZZZZZZZZZZZZZZZZZZZZZZZZZZZZZZZZZZZZZZZZZZZZZZZZZZZZ+
+ZZZZZZZZZZZZZZZZZZZZZZZZZZZZZZZZZZZZZZZZZEEZEEEEEZEEEZEEZZZZZZZZZZZZZZZZZZZZZZZZZZZZZZZZZZZZZZZZZZZZ+
+ZZZZZZZZZZZZZZZZZZZZZZZZZZZZZZZZZZZEEEEZZZZEZZZZEZZZZEZZEEEEZZZZZZZZZZZZZZZZZZZZZZZZZZZZZZZZZZZZZZZZ+
+ZZZZZZZZZZZZZZZZZZZZZZZZZZZZZZZZZZZZZZZZZGFZHHHLGEGHFZFFZZZZEEEEEEZZZZZZZZZZZZZZZZZZZZZZZZZZZZZZZZZZ+
+ZZZZZZZZZZZZZZZZZZZZZZZZZZZZZZEEEEEHJJHHJPJOKQQQNPONQJJMGGHFZZZZZZEZZZZZZZZZZZZZZZZZZZZZZZZZZZZZZZZZ+
+ZZZZZZZZZZZZZZZZZZZZZZZZZZZZZZZZZZFRUROPNMNLMKJIJMJJMNQQRQNMJKJFKIEEZZZZZZZZZZZZZZZZZZZZZZZZZZZZZZZZ+
+ZZZZZZZZZZZZZZZZZZZZZZZZZZEEEEGKLEITRNKIJKJHHHJHJKJLKJJJKJJKPONMQKEZEZEZZZZZZZZZZZZZZZZZZZZZZZZZZZZZ+
+ZZZZZZZZZZZZZZZZZZZZZZZZEZZZEZIQMNMLLKHHIJHGHHHHIIJHHIJIHIIIJKKLNQNEZEZEEZZZZZZZZZZZZZZZZZZZZZZZZZZZ+
+ZZZZZZZZZZZZZZZZZZZZZZZEZEHLLLOJHLONLGGIGGIGGKGHHHHGHJKKKLJJLMMMMMPMIEEZZZZZZZZZZZZZZZZZZZZZZZZZZZZZ+
+ZZZZZZZZZZZZZZZZZZZZZEEGIMTSRSNKLKLNLIHIIFGJGKJFGGFGJJIJKMNMLKJIJIJLNRKHFEFGZEZZZZZZZZZZZZZZZZZZZZZZ+
+ZZZZZZZZZZZZZZZZZZZZEEZJRQPNMOOLIHKLJJIFIHEKKGKHGFFHGFFJMLMNLKKKJKIIKNQVNZJFEEZZZZZZZZZZZZZZZZZZZZZZ+
+ZZZZZZZZZZZZZZZZZZZZZZHENUNOMNPNLKMMIILJGHFFLILLJGGGGGILLLOMLMMLKKLKLKLQTQPGEZZZZZZZZZZZZZZZZZZZZZZZ+
+ZZZZZZZZZZZZZZZZZZZEHIRTOOPPNLOMMLONLJLPLJIFINONPMHHIJIHILMJLONLJJIHIKKJKORTKEEZZZZZZZZZZZZZZZZZZZZZ+
+ZZZZZZZZZZZZZZZZZZEZNSQRQNMPOKLOMLMMNMKNOJJIHLONNQKHGGGILLKLNNMKJJHIMOLJJKNUUFZEZZZZZZZZZZZZZZZZZZZZ+
+ZZZZZZZZZZZZZZZZZZEEORPOQPPOLLKNOLKJKLLKNMGHIJNOKLMIGGGLLLHJPOMJIHIMNLLLKLMORNFZEZZZZZZZZZZZZZZZZZZZ+
+ZZZZZZZZZZZZZZZZEEENTSQPPPMOLKKMOMMLIJLKJNKHKILNMIKJHGIJLKFJNONHHJJKKKJJKKMKINMFEZZZZZZZZZZZZZZZZZZZ+
+ZZZZZZZZZZZZZZZZZEEPXRMNOONOLLKKOKLNOMKJHKMKKKNNPLILJIKJNJFIKMIGKONMMLJJLLKJLORIEEZZZZZZZZZZZZZZZZZZ+
+ZZZZZZZZZZZZZZZZEZZPVQMMOLMNLLLLNMLNNNLMJKIJJJOMOOJLKKLKLJHGJKJJNQPONLKKKKKKMNQIZEZZZZZZZZZZZZZZZZZZ+
+ZZZZZZZZZZZZZZZZZELSSQPPMNNOLLMLMPONPOMOPKHJJJLLNPMLJKLKKJKIJJJLPOOMLLLKJKKKKLPPHZEZZZZZZZZZZZZZZZZZ+
+ZZZZZZZZZZZZZZZZEZMTPPMNMLNMLKKLMMMMNOJLQKJLKKMLNOMLJIJKJIIKIHKMNLKKLLKKJIJKMOQRJZEZZZZZZZZZZZZZZZZZ+
+ZZZZZZZZZZZZZZZZZFPTQONLNKLLLKKLLMOMLNKJNJJKKLLMKMLLLKKKJJIJJKLKJIHIJJJKJJJKLPOQJZEZZZZZZZZZZZZZZZZZ+
+ZZZZZZZZZZZZZZZEZGSRQQOMLLKKKLKLMMONKKLJKJJLLLLKKKMLLKJKLMLKLLLLJIHHGGHHJLKLMMMOLZEZZZZZZZZZZZZZZZZZ+
+ZZZZZZZZZZZZZZZEZGRPQQONMLMLKLLLLLLMLKKKKKKLLLMLLKKLLLKLLMONMNNMLKIHGHIKLLMMMMLNMEEZZZZZZZZZZZZZZZZZ+
+ZZZZZZZZZZZZZZZEZPRPPQPNMLLLNONMMNMNNMKKLMMMMMMMLMMLLLMNOPRQPPPONNLJIHHIIJKKLLKNLZEZZZZZZZZZZZZZZZZZ+
+ZZZZZZZZZZZZZZZEEHSPOPPOMMNOQQPPPQRQQPOONNNNNMMMOPONOOOQRRSSSRQQQPOMKIIIIIKMLKJJOHZEZZZZZZZZZZZZZZZZ+
+ZZZZZZZZZZZZZZZEZJSPNOONOOOQRRRSRSSSSSSSSRRQQQRRSSRQQRRSTSTTTSSRRQQPMLLJJKMNLLMKPIZEZZZZZZZZZZZZZZZZ+
+ZZZZZZZZZZZZZZEEHRPNOOOOPPPRSTSTSSTTTUVVVVVVWWWWVUTTTTTTUUTUTSSSRRQQPPPMLLKKKKKIPIZEZZZZZZZZZZZZZZZZ+
+ZZZZZZZZZZZZZZEZGPPNNOPPPQRSTTTTSTTUVVVVWWWWXXWWWWVVVVVUUUUUTTSSRRRQRQQNKIIHHIIJOHZEZZZZZZZZZZZZZZZZ+
+ZZZZZZZZZZZZZZZEEMPMMNOOQRSSSTSRSTUUVVUUWWWWWWWWWWWWWVVVUUUUTTSSSRRQQRRPMKIIHIIJMGZEZZZZZZZZZZZZZZZZ+
+ZZZZZZZZZZZZZZEZIRMMLLNORSSSSSRSTUUUUVUVWWWWWWWWWWWWWVVVVUUUTTSSSRRQQQRQNKJIIHHHMHZEZZZZZZZZZZZZZZZZ+
+ZZZZZZZZZZZZZZEZFQOLKLMPRSSRRSSTTTUUUVVVWWWWWWWWWWWWWWVVVUUUTTSSSRQQQQQPNLKIIIIINHZEZZZZZZZZZZZZZZZZ+
+ZZZZZZZZZZZZZZZEZKOKLMNQRSSSSSTTTTUUUUVVWWWWWWWWWWWVWVVVVUUTTTTSSSQQQQPONMKJIIIINHZEZZZZZZZZZZZZZZZZ+
+ZZZZZZZZZZZZZZZEZNLKMMNOQRRRSSTTTUTTUUVVVWWWWWWWWWVWVVVVVUUUTTTSSSRQQQPONLJIJJIINIZEZZZZZZZZZZZZZZZZ+
+ZZZZZZZZZZZZZZEEEPOMLMNOQSRRRSTTTUTUUUVVVWWWWWWWWWVWVWVVVUUTUTTTSSRQPPOOMKKIIIIJOHZEZZZZZZZZZZZZZZZZ+
+ZZZZZZZZZZZZZZZEEKQKKLMPRRRRSSTTUTTTUVVUVVWWWWWWWWWWWVVVUUUUTTTTSSRPPPONMKJJIHHINJZEZZZZZZZZZZZZZZZZ+
+ZZZZZZZZZZZZZZZEZHQKKLMOQQRRSSTTUUUUUUUVWWWWWWWWWWWWWVVVUUUTUUTTSRRQPPONLKJIIHHHMGZEZZZZZZZZZZZZZZZZ+
+ZZZZZZZZZZZZZZZZZFQKKLMOPQRRSSTTTTUUUUVVVVWVWWWWWWWWVVVVUUUTTTTSSRQQPPONMKIIHIHGMHZEZZZZZZZZZZZZZZZZ+
+ZZZZZZZZZZZZZZZZZEMKKLLNPQQRSSSTTUUUUVVVVVVVVWWWVVVVVVUVUUTTTTSSSRQPPONMMLJIHHHHNHZEZZZZZZZZZZZZZZZZ+
+ZZZZZZZZZZZZZZZEEEHMJKMNPQRRRSSTTTTUUUUVVVVVVVWVVVVVUVVUUUTUTTSSSRQQPONLKJKJHHHINGZEZZZZZZZZZZZZZZZZ+
+ZZZZZZZZZZZZZZZZEZINJLLMOQQRRSSTTTUTUUVVVVVVVVVWVVVVUVVVUUUUUTSRRRQQPONMKJJJHHHJLEZZZZZZZZZZZZZZZZZZ+
+ZZZZZZZZZZZZZZZZEZINJLLMOQQRRSTTTUUTUVVVVVWWVVWWVWWWWWWVUUUTUTSSRRRQONMMLIIJIHHJJZEZZZZZZZZZZZZZZZZZ+
+ZZZZZZZZZZZZZZZZEZHNKKLNPQQRSSTTTUUUUVVVWWVWWVWVWWVVVWWVUUUUTTSSSRRQONMNMIIJIIIIIZEZZZZZZZZZZZZZZZZZ+
+ZZZZZZZZZZZZZZZZEZGMKKLNQQQQSSSTTTUUUVVVVVWWWWWVVWVVVVVVUUUUUTSSSSQPONNNMJIIIIIIJEZEZZZZZZZZZZZZZZZZ+
+ZZZZZZZZZZZZZZZZEEKMLKMOQQQRRSTTUUUUUVVVVVVVVVVVVVUVVVVUUUUTTTSSSRRQONNNNKIIJJIHLHZEZZZZZZZZZZZZZZZZ+
+ZZZZZZZZZZZZZZZZZEQMMLMOQQQRSTTTUTUUTUVVVVUUVUUVUUUUTTTTSSSSRQQQQRQQOMNNNLIIJKJHNKZEZZZZZZZZZZZZZZZZ+
+ZZZZZZZZZZZZZZZZZEPNMLMORQQSSSSRQRRSSSSSTTTTUUUUTTTTRQPPOPPOOPONNQQQONNNNLIHIKKIMIZEZZZZZZZZZZZZZZZZ+
+ZZZZZZZZZZZZZZZEEKONMMMORQRRRRQPPPPPQPOOOQRRSUVUSSSQPMKKJKLKMONNNOOONMMONLIIIJKKMGZEZZZZZZZZZZZZZZZZ+
+ZZZZZZZZZZZZZZZEZPOMMLLOSQQQQQQPONLLLLKKLNPQSUVVTSQOLJJJJJKLNNOOPNNNMLNONMJIIJKLLMEZZZZZZZZZZZZZZZZZ+
+ZZZZZZZZZZZZZZEEFPPNLLLPSQPQPQQPPONMKJKKLLMPSTUVUSPMJJKLLMNQRQQQPNMMLLMNNNKJIJLLKQFZZZZZZZZZZZZZZZZZ+
+ZZZZZZZZZZZZZZEZKOMNMLMQSQOOPQQQQPONMKKKLLLORTVWUTQMLMMKKLLLMNOOONLLKLMNONKJJJMMHLEZZZZZZZZZZZZZZZZZ+
+ZZZZZZZZZZZZZZEZLPLNMLMQRQPPPPONOMKLNKLMMMMOQTVVVTQOMLMMMLJLHIJLLLNNLMNOOOLJKLMKIKEZZZZZZZZZZZZZZZZZ+
+ZZZZZZZZZZZZZZEZKROONMNQRQPPPOLNNLJJKKNNNQPORTUVUTQQMOPNPPMHHJJKKKNOONOOOOMJJLLLLMMZEZZZZZZZZZZZZZZZ+
+ZZZZZZZZZZZZZZEZJSQQOMORRRQQPONNMQNKJORTPNRRRSUUUTRQQSNPTTPOONPMLMOPOPRPOOOLIJMNMOQZEZZZZZZZZZZZZZZZ+
+ZZZZZZZZZZZZZZEZIRRRPNNRSSSRQPPOPSQPRQTTTSSSRSUUUTSQRSTTSTSSSRQQOPQONQRQPOOMKKMOOPLZEZZZZZZZZZZZZZZZ+
+ZZZZZZZZZZZZZZEZHRSRQOORSTTRSTRRRRSSSTTTVVSSSSUUUUSPQSUVUSSRQRRRRSSSRRRSQPPMKKMPPPIZEZZZZZZZZZZZZZZZ+
+ZZZZZZZZZZZZZZEZGRTRQOPSSTTTTTTSSSSSSTTUUTSSSTUUUUSQQRSTUTSSRQRQRTSTTSSSRPPNKKMPQQLZEZZZZZZZZZZZZZZZ+
+ZZZZZZZZZZZZZZEZFQURRPQSSTTVUTUUTSTTUUUUTTSSSSTUUUSQQQSTUUUTTTTUUUTTUTSSRPPNKJNPRSPZEZZZZZZZZZZZZZZZ+
+ZZZZZZZZZZZZZZZEZPVSRQQSSTUVVUUVVUUVVVUTTTSSSTTUUUTQQQSTUUUUTTTUUUUUUTTSRQOMLLNQSTOZEZZZZZZZZZZZZZZZ+
+ZZZZZZZZZZZZZZZEZOUSRRRSSUUUVUUUUUUVUUUTTTTTSTTUVVTQRRRTVUUTTUUTTUUTUTTSRQOMMPPRSTOZEZZZZZZZZZZZZZZZ+
+ZZZZZZZZZZZZZZZEZLUSSSSSTTUUUVUUUUUUUUVUTTTTTTUUUUSRRRSTUUVUUUTTUTUUTTTSQQOMNRRQSSHZEZZZZZZZZZZZZZZZ+
+ZZZZZZZZZZZZZZZEZJSTSSRSSTUUUVUUUUUUVVVUTTTTTTTUVUTQPQSSTUVVVVUUUUUUTTTSQPOLNQRRSQEZZZZZZZZZZZZZZZZZ+
+ZZZZZZZZZZZZZZZZZFRSUSRSTTTUUVVVVVVVVVUUTTTSSSTUVVTQOQRSTUVVVVVVVUVUUTSSQONLOORSQPEZZZZZZZZZZZZZZZZZ+
+ZZZZZZZZZZZZZZZZZEOTUTRRSSTUVVWVVVVVWVUUTSSSSSTVVVTPQSSRSTUUVVVVVUUUUTSRPNNLOQSRNMEZZZZZZZZZZZZZZZZZ+
+ZZZZZZZZZZZZZZZZEZHTTTQRSSUVVVVVVVVVVVVTTSTTTTUVWXUQRTSSQRTUVVUUVUUTTTSRPNMLMPRQQHZEZZZZZZZZZZZZZZZZ+
+ZZZZZZZZZZZZZZZZEZFQTSQQRTTUVVVVVVVWVUTSSTTTTTUVWXURRSSSPPQRTTUUUUTTTSRQONMLMPQQNFZEZZZZZZZZZZZZZZZZ+
+ZZZZZZZZZZZZZZZZEZEOTSSQQSTTUUUVVVUVVTSSSTTTSTUUUUURQSRRQQRQRSTUUTTTSSRPNMMLORRQKZEZZZZZZZZZZZZZZZZZ+
+ZZZZZZZZZZZZZZZZZEZMTSTQQRSTTUUUUUUTTSSSRSOMNPRTTTSOMKKMOSSRQRSTTTTSRRQOMNMMPRQPJZEZZZZZZZZZZZZZZZZZ+
+ZZZZZZZZZZZZZZZZZEZFRTTQPQRTTUUUTTTSRSTURNIGHKPQRROLGEFHMRSTRPQRRRRRRQOMMNMNQRPOEZZZZZZZZZZZZZZZZZZZ+
+ZZZZZZZZZZZZZZZZZZEZKPRRQPQSSTTTSSSRRTUUSNLMNLLNNNLHHIJKORSTTRPPQQQQQPNMMNMMPPPLZEZZZZZZZZZZZZZZZZZZ+
+ZZZZZZZZZZZZZZZZZZZEZHOPQPQRRSTSSRQRUVUUSRRQPOMLKJIIKLNOPRSSTTRPPPPPPNMMNNMONNKZEZZZZZZZZZZZZZZZZZZZ+
+ZZZZZZZZZZZZZZZZZZZZEZFKQQPPQRRSRRSTUUUTTSSQQPOMIHILNOPQQRRSRSSSPPPONMMNONNSOGZEZZZZZZZZZZZZZZZZZZZZ+
+ZZZZZZZZZZZZZZZZZZZZZEZFQRQPPQQQRSTUTUUUUTSRRQQOKKLNPPQSRRRQRRRSQPOONMMOOMPNZEEZZZZZZZZZZZZZZZZZZZZZ+
+ZZZZZZZZZZZZZZZZZZZZZEEGQRRQQRRRSTTTTTTTUTTSSSRONNNPQQRRRRRQQRRRRPPPONNPONMFEZZZZZZZZZZZZZZZZZZZZZZZ+
+ZZZZZZZZZZZZZZZZZZZZZEZGQRRRRRRRSTSSSSTTTTTTSSRQQQRRRRRRQRQPPQRSRQQQPPPPPNLZEZZZZZZZZZZZZZZZZZZZZZZZ+
+ZZZZZZZZZZZZZZZZZZZZZEZFPRRSRSSRSSSRQRSSTTTTUUVUTTUUSSSSSRPNNORRQPRQQPPPPNNEEZZZZZZZZZZZZZZZZZZZZZZZ+
+ZZZZZZZZZZZZZZZZZZZZZEZFORRSSTTSRSSRPQSTTUUTUTTUUUURQRRRQQOMKPSRPPRQQPPQOMMZZZZZZZZZZZZZZZZZZZZZZZZZ+
+ZZZZZZZZZZZZZZZZZZZZZZZEMRSSSTTTRSTSPMQRRQQPQQQRSSQPPNLKKJIIMRTRPRSRPPQPNMIEZZZZZZZZZZZZZZZZZZZZZZZZ+
+ZZZZZZZZZZZZZZZZZZZZZZEZKRSSRSTTSRSTSOLLLLMMNOPPPPOONLLLMLMPTUTQQRSQOPQPNNFZEZZZZZZZZZZZZZZZZZZZZZZZ+
+ZZZZZZZZZZZZZZZZZZZZZZEZJQRSRRSTTSSTUURQPQRQQQPPPPQPQSSRRRQQSUSQRRRPPQQPLNGZEZZZZZZZZZZZZZZZZZZZZZZZ+
+ZZZZZZZZZZZZZZZZZZZZZZEZGORRRRRSTTSTTTSSSSSTUVVVVUUVUSRRRQORTTRQQRQQPPPNMIEEZZZZZZZZZZZZZZZZZZZZZZZZ+
+ZZZZZZZZZZZZZZZZZZZZZZZEZNPRSRRRSSSSTTSQRSRRSTVWWVVUSRQRPNPSTSSRQQPQQQOLMJZEZZZZZZZZZZZZZZZZZZZZZZZZ+
+ZZZZZZZZZZZZZZZZZZZZZZZEZKOQRRRRRSSSTTTRQQRRRRSTTTTSRRPNMNRSSSRRQQPPPPNLKGEZZZZZZZZZZZZZZZZZZZZZZZZZ+
+ZZZZZZZZZZZZZZZZZZZZZZZEZFOOQRRRRSRSSSSSRPOOPQQQQQQPONLKNQRRRRRQQQPPPOMKKZEZZZZZZZZZZZZZZZZZZZZZZZZZ+
+ZZZZZZZZZZZZZZZZZZZZZZZZEEKOPQQQQRRSSSSSRQONMLLLLKKKJJKNPQRRRRQQPPQPPNKMEEZZZZZZZZZZZZZZZZZZZZZZZZZZ+
+ZZZZZZZZZZZZZZZZZZZZZZZZEZGNOPQQQRRSSTTSSRQOMLKKLKKKKLNPQQSRRQQQPQQPNLJMEZZZZZZZZZZZZZZZZZZZZZZZZZZZ+
+ZZZZZZZZZZZZZZZZZZZZZZZZZEZJNOQQQRRRSSSSSSRRPOONNMMMNOQQQRSRRRQPQQOOMKJKEZZZZZZZZZZZZZZZZZZZZZZZZZZZ+
+ZZZZZZZZZZZZZZZZZZZZZZZZZZZELNPQQQRRSSSSSSTSSRQQQPQQQRRRSSSRRRQPPOOMKIKHZZZZZZZZZZZZZZZZZZZZZZZZZZZZ+
+ZZZZZZZZZZZZZZZZZZZZZZZZZZEEGONPPPQRSSSSTTTUTTSTTSSSSSTTTSSRQQPOONNKJILGEEZZZZZZZZZZZZZZZZZZZZZZZZZZ+
+ZZZZZZZZZZZZZZZZZZZZZZZZZZEZJOMNPPPQSSTTTTUUTUUTTTUUTSSTSSRRRQONMLKJIIKKZZZZZZZZZZZZZZZZZZZZZZZZZZZZ+
+ZZZZZZZZZZZZZZZZZZZZZZZZZEZIJMNLNOOPRRSTTTTTTTTTTTTTTSTTSRSRQPNLLKIHHJKJJZEZZZZZZZZZZZZZZZZZZZZZZZZZ+
+ZZZZZZZZZZZZZZZZZZZZZZZZEZEJEMOLLLMOQRSSTSSTTTTTSSTSSSSSRRRQPNLKJIHHIJLFIKZEEZZZZZZZZZZZZZZZZZZZZZZZ+
+ZZZZZZZZZZZZZZZZZZZZZZZEZELGFMPMLKLLORSSSSSSSTTSTSSSSSSRRQQQOMJIHHHIIJKGEJKZZZZZZZZZZZZZZZZZZZZZZZZZ+
+ZZZZZZZZZZZZZZZZZZZZZZEZELIFFLPNLKKKLORRSSSSSSSSSSSSSSRQPQQOMJHHHHHIJKKFFFIKEEEZZZZZZZZZZZZZZZZZZZZZ+
+ZZZZZZZZZZZZZZZZZZZZZEZEKIGGEKPNMLKKKLORRRRSSRRSSSSRRQPPPPOMIHHHHHIIJKKFFGEJKZZEZZZZZZZZZZZZZZZZZZZZ+
+ZZZZZZZZZZZZZZZZZZZZEZELIGHGEJPONMLKKKLNPQQQQQQQQQQPPONNNMKIHGHHHHIJJKKFEFGEIKGZEEEZZZZZZZZZZZZZZZZZ+
+ZZZZZZZZZZZZZZZEEZZZZGKIGHGGEHOOOMLKKKJKLMNOOOOOONONMLLKKJHGHHHHHIJKKLKEEFFGFGLIZZZZZEEZZZZZZZZZZZZZ+
+ZZZZZZZZZZZZZEEZZZEEKKHGHGGGEHOOOOMLLLKKJJKLLMLLLLLKJIIIHGHHHHHHIJJKKLKFFFFFGFFKKKFEZZZEEZZZZZZZZZZZ+
+ZZZZZZZZZZZEEZZEGIMKJGGGGGGFEHOPOONMLLLLKKJIJJJJIIIIHHGGGHHHHIHIIJKKLLKFEFFFFGGFIJKNJGFZZEEZZZZZZZZZ+
+ZZZZZZEEEZZZZGJKMIHHGHHGGGGGFIOPPONNNMLLLKKJJIIIIHHHGGHHHHHHIIHIJJKLLLKFFGFFFFGGFGGGILLJIZZZZEEZZZZZ+
+ZZZEEEZZZEEHLKKIGGHHHHGGGGGGFJNPPPONNNMLLLKKKJJIIIHHHHHHHHHHIIIJJKLLLMLGFGFFFFGGGGGGGFGJLLLFFZZEEEZZ+
+ZZZZZZFHHLLJIHHHHHHHHHHGGGGGFJNPPPPPONNMMLLKKKJJIIIHHHHHHHIIIIJJKLLMMMLGFGFFFFGGGGGGGHGGGHILMIIEZZZZ+
+ZEEJLJKLJIHHHHHHHHHHHHGGHGGGGKNPQQPPPONNMMLLKKJJIIIHHHHHHIIIIJJKKLMMMMKHFGFGFGGGGGGGGGGGHHGGHJMKLGZZ+
+IMJKKIIHHHHHHHHGHHHHHHHHHHHGGMMOQQQPPPONNMMMLKKJIHHHHHHHIIIIJJJKLMMMMMLHFGFGGGGGGGGGGGGGGGGHGGGHJKNJ+
+IHHHHHHHHHHHHHHHHHHHHHHHGGGGHNNOQQQQPOOONNMMLLKKJIIIHHIIIIIJJJKLMMNMNMLIFGGGGGGGGGGGGGGGGGGGGHHGGGHJ+
+HHHHHHHHHHHHHHHHHHHHHHHHGHHGIOONQRQQQPPONNNMLLLLKJJJIIIIIIIJJKLMMNNNNNMJFGGGGGGGGGGGGGGGGGGGGGGGGGHH+
+HHHHHHHHHHHHHHHHHHHHHHHHHHHGIPPOPRRRQQQPONNNMLLLLKKJJJIIIJJJKLMNNNNNNNNKFGGGGGGGGGGGGGGGGGGGGGGGGGGH+
+HHHHHHHHHHHHHHHHHHHHHHHHHHHGIPQOPQRRRQQQPONNMMLLLKKJJIJJJJKKKLMNNNNNOOOLFGGGGGGGGGGGGGGGGGGGGGGGGGGH+
+HHHHHHHHHHHHHHHHHHHHHHHHHHHGIQRPPQRRRRRQPPONMMMLLLKKKJKKKKKKMMNNNNNOOOPLFGGGGGGGGGGGHGGGGGGGGGGGGGGG+
+HHHHHHHHHHHHHHHHHHHHHHHHHHHGHPSQPQRRRRRRQQPONNMMMLLLKKKLLLLMMNNOONOPPOQLFGGGGGGGGGGHGFFGGGGGGGGGGGGG+
+HHHHHHHHHHHHHHHGGHHHHHHHHHHGGQTRQQRRRRRRQQQPOONNNMMMMLLLLLMMNNOONNOPPPQKFGGGGGGGGGGGFFGGHGGGGGGGGGGG+
+HHHHHHHHHHHHHHHHGGGHHHHHHHHHGMURQRQRRRRRRQQQPPPONNNNNMMMMMMMNOOOOPPPPQRKFGGGGGGGGGFFGGGGGGGGGGGGGGGG+
+HHHHHHHHHHGHHHHHHHGFFGHHHHHHGFNTRRRRRRRRRRRQQQQPPOONNNNNNMNNOOOOOPPQQQRIGHGGGGGGFFGGGGGGGGGGGGGGGGGG+
+HHHHHHHHGHGHHHHHHHHHGFGHHHHHHGFNTRRRRRRRRRRRQQQPPPPOOOONNNOOOOOOPPQQQSMGGGGGGGGGGGGGGGGGGGGGGGGGGGGG+
+HHHHHHHHHHHHHHHHHHHHHHGHHHHHGGFFMSRRQQRRRRRRQQPPOOOOONNNNOOOPPPPPQRQSOFGHGGGGGGGGGGGGGGGGGGGGGGGGGGG+
+HHHHHHHHHHGGHHHHHHHHHHHHHHHHHGGFFLRSQQQRRRRRRQPPOONNNNNOOPPPPPPPQRRTPGFGHGGGGGGGGGGGGGGGGGGGGGGGGGGG+
+HHHHHHHHHHGGHHHHHHHHHHHHHHHHHGGGGFKRSQQQQRRRRQQPOONOOOOOPPPPQPPQQRUPGEFGHGGGGGGGGGGGGGGGGGGGGGGGGGGG+
+HHHHHHHHHHGGHHHHHHHHHHHHHHHHHGGGGGFIPSQQQRRRRRQQPOOOPPPPPPQQQQPQSTOGFGFGHGGGGGGGGGGGGGGGGGGGGGGGGGGG+
+HHHHHHHHHHGGHHHHHHHHHHHHHHHHHGGGGGGFGNSRQRRRRQQQQPPPPPPPQQRRQPQSSLFFFGFGHGGGGGGGGGGGGGGGGGFGGGGGGGGG+
+HHHHHHHHHHHGHHHHHHHHHHHHHHHHGGGGGGGGFFJPRRRSSRRQQQPPPPQQRRSRQRSPIFGGGFFGHGGGGGGGGGGGGGGGGGFGGGGGGGGG+
+HHHHHHHHHHHGHHHHHHHHHHHHHHHGGGGGGGGGGGFGKQSSSSRRRQQQQQRRSSSTSQLFFGGGGGFGHGGGGGGGGGGGGGGGHGFGGGGGGGGG+
+HHHHHHHHHHHGHHHHHHHHHHHHHHHHHGGGGGGGGGGGFHMSUTSRRRRRRRRSTUTQKFFGGFGFGGGGHGGGGGGGGGGGGGGGGGFGGGGGGGGG+
+HHHHHHHHHHHGHHHHHHHHHHHHHHHHHGGGGGGGGGGGGFFHNSTTTSSSSTTUSOJFFFGFFFFGGGFGHGGGGGGGGGGGGGGGGGFGGGGGGGGG+
+HHHHHHHHHHHGHHHHHHHHHHHHHHHHHGGGGGGGGGGGGGGFFGLPRSSSSRPLGEEFGFFFFFGGGGFGHGGGGGGGGGGGGGGGGGFGGGGGGGGG+
+HHHHHHHHHHHGHHHHHHHHHHHHHHHHHHGGGGGGGGGGGGGGGFFFGHHHHGFEFFGGFFFGGGGGGFGGHGGGGGGGGGGGGGGGGGGGGGGGGGGG+
+HHHHHHHHHHHGHHHHHHHHHHHHHHHHHHGGGGGGGGGGGFFGGGGFFFFFFFFFFFGFFFGGGGGGFGGGGGGGGGGGGGGGGGGGGGGGGGGGGGGG+
+HHHHHHHGHHHHHHHHHHHHHHHHHHHHHHGGGGGGGGGGGGGFGFFFFGGGFFFFFFFGGGGGGGGGFGGGGGGGGGGGGGGGGGGGGGFGGGGGGGGG+
+HHHHHHHHHHHGGHHHHHHHHHHHHHHHHHGGGGGGGGGGGGGGGGGFFFFFFFFFFGGGFGGGGGGFFGGGGGGGGGGGGGGGGGGGGGGGGGGGGGGG+
+HHHHHHHHHHHGGHHHHHHHHHHHHHHHHHGGGGGGGGGGGGGGGGGGGGGGGGGGGGGFFGGGGGGFGGGGGGGGGGGGGGGGGGGGHGGGGGGGGGGG+
+HHHHHHHGHHHGHHHHHHHHHHHHHHHHHHGFGGGGGGGGGGGFFFGGGGGGGGGGGGFFGGGGGGGFGGGGGGGGGGGGGGGGGGGGGGFGGGGGGGGH+
+HHHHHHHHHHHHHHHHHHHHHHHHHHHHHHGGGGGGGGGGGGGGFFFGGGFFGGGGFFFGGGGGGGGGGGGGHGGGGGGGGHHGGGGGHGFGGGGHGGHH+
++++++++++++++++++++++++++++++++++++++++++++++++++++++++++++++++++++++++++++++++++++++++++++++++++++++
#goal
++++++++++++++++++++++++++++++++++++++++++++++++++++++++++++++++++++++++++++++++++++++++++++++++++++++
+0ZZZZZZZZZZZZZZZZZZZZZZZZZZZZZZZZZZZZZZZZZZZZZZZZZZZZZZZZZZZZZZZZZZZZZZZZZZZZZZZZZZZZZZZZZZZZZZZZZZZ+
+ZZZZZZZZZZZZZZZZZZZZZZZZZZZZZZZZZZZZZZZZZZZZZZZZZZZZZZZZZZZZZZZZZZZZZZZZZZZZZZZZZZZZZZZZZZZZZZZZZZZZ+
+ZZZZZZZZZZZZZZZZZZZZZZZZZZZZZZZZZZZZZZZZZZZZZZZZZZZZZZZZZZZZZZZZZZZZZZZZZZZZZZZZZZZZZZZZZZZZZZZZZZZZ+
+ZZZZZZZZZZZZZZZZZZZZZZZZZZZZZZZZZZZZZZZZZZZZZZZZZZZZZZZZZZZZZZZZZZZZZZZZZZZZZZZZZZZZZZZZZZZZZZZZZZZZ+
+ZZZZZZZZZZZZZZZZZZZZZZZZZZZZZZZZZZZZZZZZZEEZEEEEEZEEEZEEZZZZZZZZZZZZZZZZZZZZZZZZZZZZZZZZZZZZZZZZZZZZ+
+ZZZZZZZZZZZZZZZZZZZZZZZZZZZZZZZZZZZEEEEZZZZEZZZZEZZZZEZZEEEEZZZZZZZZZZZZZZZZZZZZZZZZZZZZZZZZZZZZZZZZ+
+ZZZZZZZZZZZZZZZZZZZZZZZZZZZZZZZZZZZZZZZZZGFZHHHLGEGHFZFFZZZZEEEEEEZZZZZZZZZZZZZZZZZZZZZZZZZZZZZZZZZZ+
+ZZZZZZZZZZZZZZZZZZZZZZZZZZZZZZEEEEEHJJHHJPJOKQQQNPONQJJMGGHFZZZZZZEZZZZZZZZZZZZZZZZZZZZZZZZZZZZZZZZZ+
+ZZZZZZZZZZZZZZZZZZZZZZZZZZZZZZZZZZFRUROPNMNLMKJIJMJJMNQQRQNMJKJFKIEEZZZZZZZZZZZZZZZZZZZZZZZZZZZZZZZZ+
+ZZZZZZZZZZZZZZZZZZZZZZZZZZEEEEGKLEITRNKIJKJHHHJHJKJLKJJJKJJKPONMQKEZEZEZZZZZZZZZZZZZZZZZZZZZZZZZZZZZ+
+ZZZZZZZZZZZZZZZZZZZZZZZZEZZZEZIQMNMLLKHHIJHGHHHHIIJHHIJIHIIIJKKLNQNEZEZEEZZZZZZZZZZZZZZZZZZZZZZZZZZZ+
+ZZZZZZZZZZZZZZZZZZZZZZZEZEHLLLOJHLONLGGIGGIGGKGHHHHGHJKKKLJJLMMMMMPMIEEZZZZZZZZZZZZZZZZZZZZZZZZZZZZZ+
+ZZZZZZZZZZZZZZZZZZZZZEEGIMTSRSNKLKLNLIHIIFGJGKJFGGFGJJIJKMNMLKJIJIJLNRKHFEFGZEZZZZZZZZZZZZZZZZZZZZZZ+
+ZZZZZZZZZZZZZZZZZZZZEEZJRQPNMOOLIHKLJJIFIHEKKGKHGFFHGFFJMLMNLKKKJKIIKNQVNZJFEEZZZZZZZZZZZZZZZZZZZZZZ+
+ZZZZZZZZZZZZZZZZZZZZZZHENUNOMNPNLKMMIILJGHFFLILLJGGGGGILLLOMLMMLKKLKLKLQTQPGEZZZZZZZZZZZZZZZZZZZZZZZ+
+ZZZZZZZZZZZZZZZZZZZEHIRTOOPPNLOMMLONLJLPLJIFINONPMHHIJIHILMJLONLJJIHIKKJKORTKEEZZZZZZZZZZZZZZZZZZZZZ+
+ZZZZZZZZZZZZZZZZZZEZNSQRQNMPOKLOMLMMNMKNOJJIHLONNQKHGGGILLKLNNMKJJHIMOLJJKNUUFZEZZZZZZZZZZZZZZZZZZZZ+
+ZZZZZZZZZZZZZZZZZZEEORPOQPPOLLKNOLKJKLLKNMGHIJNOKLMIGGGLLLHJPOMJIHIMNLLLKLMORNFZEZZZZZZZZZZZZZZZZZZZ+
+ZZZZZZZZZZZZZZZZEEENTSQPPPMOLKKMOMMLIJLKJNKHKILNMIKJHGIJLKFJNONHHJJKKKJJKKMKINMFEZZZZZZZZZZZZZZZZZZZ+
+ZZZZZZZZZZZZZZZZZEEPXRMNOONOLLKKOKLNOMKJHKMKKKNNPLILJIKJNJFIKMIGKONMMLJJLLKJLORIEEZZZZZZZZZZZZZZZZZZ+
+ZZZZZZZZZZZZZZZZEZZPVQMMOLMNLLLLNMLNNNLMJKIJJJOMOOJLKKLKLJHGJKJJNQPONLKKKKKKMNQIZEZZZZZZZZZZZZZZZZZZ+
+ZZZZZZZZZZZZZZZZZELSSQPPMNNOLLMLMPONPOMOPKHJJJLLNPMLJKLKKJKIJJJLPOOMLLLKJKKKKLPPHZEZZZZZZZZZZZZZZZZZ+
+ZZZZZZZZZZZZZZZZEZMTPPMNMLNMLKKLMMMMNOJLQKJLKKMLNOMLJIJKJIIKIHKMNLKKLLKKJIJKMOQRJZEZZZZZZZZZZZZZZZZZ+
+ZZZZZZZZZZZZZZZZZFPTQONLNKLLLKKLLMOMLNKJNJJKKLLMKMLLLKKKJJIJJKLKJIHIJJJKJJJKLPOQJZEZZZZZZZZZZZZZZZZZ+
+ZZZZZZZZZZZZZZZEZGSRQQOMLLKKKLKLMMONKKLJKJJLLLLKKKMLLKJKLMLKLLLLJIHHGGHHJLKLMMMOLZEZZZZZZZZZZZZZZZZZ+
+ZZZZZZZZZZZZZZZEZGRPQQONMLMLKLLLLLLMLKKKKKKLLLMLLKKLLLKLLMONMNNMLKIHGHIKLLMMMMLNMEEZZZZZZZZZZZZZZZZZ+
+ZZZZZZZZZZZZZZZEZPRPPQPNMLLLNONMMNMNNMKKLMMMMMMMLMMLLLMNOPRQPPPONNLJIHHIIJKKLLKNLZEZZZZZZZZZZZZZZZZZ+
+ZZZZZZZZZZZZZZZEEHSPOPPOMMNOQQPPPQRQQPOONNNNNMMMOPONOOOQRRSSSRQQQPOMKIIIIIKMLKJJOHZEZZZZZZZZZZZZZZZZ+
+ZZZZZZZZZZZZZZZEZJSPNOONOOOQRRRSRSSSSSSSSRRQQQRRSSRQQRRSTSTTTSSRRQQPMLLJJKMNLLMKPIZEZZZZZZZZZZZZZZZZ+
+ZZZZZZZZZZZZZZEEHRPNOOOOPPPRSTSTSSTTTUVVVVVVWWWWVUTTTTTTUUTUTSSSRRQQPPPMLLKKKKKIPIZEZZZZZZZZZZZZZZZZ+
+ZZZZZZZZZZZZZZEZGPPNNOPPPQRSTTTTSTTUVVVVWWWWXXWWWWVVVVVUUUUUTTSSRRRQRQQNKIIHHIIJOHZEZZZZZZZZZZZZZZZZ+
+ZZZZZZZZZZZZZZZEEMPMMNOOQRSSSTSRSTUUVVUUWWWWWWWWWWWWWVVVUUUUTTSSSRRQQRRPMKIIHIIJMGZEZZZZZZZZZZZZZZZZ+
+ZZZZZZZZZZZZZZEZIRMMLLNORSSSSSRSTUUUUVUVWWWWWWWWWWWWWVVVVUUUTTSSSRRQQQRQNKJIIHHHMHZEZZZZZZZZZZZZZZZZ+
+ZZZZZZZZZZZZZZEZFQOLKLMPRSSRRSSTTTUUUVVVWWWWWWWWWWWWWWVVVUUUTTSSSRQQQQQPNLKIIIIINHZEZZZZZZZZZZZZZZZZ+
+ZZZZZZZZZZZZZZZEZKOKLMNQRSSSSSTTTTUUUUVVWWWWWWWWWWWVWVVVVUUTTTTSSSQQQQPONMKJIIIINHZEZZZZZZZZZZZZZZZZ+
+ZZZZZZZZZZZZZZZEZNLKMMNOQRRRSSTTTUTTUUVVVWWWWWWWWWVWVVVVVUUUTTTSSSRQQQPONLJIJJIINIZEZZZZZZZZZZZZZZZZ+
+ZZZZZZZZZZZZZZEEEPOMLMNOQSRRRSTTTUTUUUVVVWWWWWWWWWVWVWVVVUUTUTTTSSRQPPOOMKKIIIIJOHZEZZZZZZZZZZZZZZZZ+
+ZZZZZZZZZZZZZZZEEKQKKLMPRRRRSSTTUTTTUVVUVVWWWWWWWWWWWVVVUUUUTTTTSSRPPPONMKJJIHHINJZEZZZZZZZZZZZZZZZZ+
+ZZZZZZZZZZZZZZZEZHQKKLMOQQRRSSTTUUUUUUUVWWWWWWWWWWWWWVVVUUUTUUTTSRRQPPONLKJIIHHHMGZEZZZZZZZZZZZZZZZZ+
+ZZZZZZZZZZZZZZZZZFQKKLMOPQRRSSTTTTUUUUVVVVWVWWWWWWWWVVVVUUUTTTTSSRQQPPONMKIIHIHGMHZEZZZZZZZZZZZZZZZZ+
+ZZZZZZZZZZZZZZZZZEMKKLLNPQQRSSSTTUUUUVVVVVVVVWWWVVVVVVUVUUTTTTSSSRQPPONMMLJIHHHHNHZEZZZZZZZZZZZZZZZZ+
+ZZZZZZZZZZZZZZZEEEHMJKMNPQRRRSSTTTTUUUUVVVVVVVWVVVVVUVVUUUTUTTSSSRQQPONLKJKJHHHINGZEZZZZZZZZZZZZZZZZ+
+ZZZZZZZZZZZZZZZZEZINJLLMOQQRRSSTTTUTUUVVVVVVVVVWVVVVUVVVUUUUUTSRRRQQPONMKJJJHHHJLEZZZZZZZZZZZZZZZZZZ+
+ZZZZZZZZZZZZZZZZEZINJLLMOQQRRSTTTUUTUVVVVVWWVVWWVWWWWWWVUUUTUTSSRRRQONMMLIIJIHHJJZEZZZZZZZZZZZZZZZZZ+
+ZZZZZZZZZZZZZZZZEZHNKKLNPQQRSSTTTUUUUVVVWWVWWVWVWWVVVWWVUUUUTTSSSRRQONMNMIIJIIIIIZEZZZZZZZZZZZZZZZZZ+
+ZZZZZZZZZZZZZZZZEZGMKKLNQQQQSSSTTTUUUVVVVVWWWWWVVWVVVVVVUUUUUTSSSSQPONNNMJIIIIIIJEZEZZZZZZZZZZZZZZZZ+
+ZZZZZZZZZZZZZZZZEEKMLKMOQQQRRSTTUUUUUVVVVVVVVVVVVVUVVVVUUUUTTTSSSRRQONNNNKIIJJIHLHZEZZZZZZZZZZZZZZZZ+
+ZZZZZZZZZZZZZZZZZEQMMLMOQQQRSTTTUTUUTUVVVVUUVUUVUUUUTTTTSSSSRQQQQRQQOMNNNLIIJKJHNKZEZZZZZZZZZZZZZZZZ+
+ZZZZZZZZZZZZZZZZZEPNMLMORQQSSSSRQRRSSSSSTTTTUUUUTTTTRQPPOPPOOPONNQQQONNNNLIHIKKIMIZEZZZZZZZZZZZZZZZZ+
+ZZZZZZZZZZZZZZZEEKONMMMORQRRRRQPPPPPQPOOOQRRSUVUSSSQPMKKJKLKMONNNOOONMMONLIIIJKKMGZEZZZZZZZZZZZZZZZZ+
+ZZZZZZZZZZZZZZZEZPOMMLLOSQQQQQQPONLLLLKKLNPQSUVVTSQOLJJJJJKLNNOOPNNNMLNONMJIIJKLLMEZZZZZZZZZZZZZZZZZ+
+ZZZZZZZZZZZZZZEEFPPNLLLPSQPQPQQPPONMKJKKLLMPSTUVUSPMJJKLLMNQRQQQPNMMLLMNNNKJIJLLKQFZZZZZZZZZZZZZZZZZ+
+ZZZZZZZZZZZZZZEZKOMNMLMQSQOOPQQQQPONMKKKLLLORTVWUTQMLMMKKLLLMNOOONLLKLMNONKJJJMMHLEZZZZZZZZZZZZZZZZZ+
+ZZZZZZZZZZZZZZEZLPLNMLMQRQPPPPONOMKLNKLMMMMOQTVVVTQOMLMMMLJLHIJLLLNNLMNOOOLJKLMKIKEZZZZZZZZZZZZZZZZZ+
+ZZZZZZZZZZZZZZEZKROONMNQRQPPPOLNNLJJKKNNNQPORTUVUTQQMOPNPPMHHJJKKKNOONOOOOMJJLLLLMMZEZZZZZZZZZZZZZZZ+
+ZZZZZZZZZZZZZZEZJSQQOMORRRQQPONNMQNKJORTPNRRRSUUUTRQQSNPTTPOONPMLMOPOPRPOOOLIJMNMOQZEZZZZZZZZZZZZZZZ+
+ZZZZZZZZZZZZZZEZIRRRPNNRSSSRQPPOPSQPRQTTTSSSRSUUUTSQRSTTSTSSSRQQOPQONQRQPOOMKKMOOPLZEZZZZZZZZZZZZZZZ+
+ZZZZZZZZZZZZZZEZHRSRQOORSTTRSTRRRRSSSTTTVVSSSSUUUUSPQSUVUSSRQRRRRSSSRRRSQPPMKKMPPPIZEZZZZZZZZZZZZZZZ+
+ZZZZZZZZZZZZZZEZGRTRQOPSSTTTTTTSSSSSSTTUUTSSSTUUUUSQQRSTUTSSRQRQRTSTTSSSRPPNKKMPQQLZEZZZZZZZZZZZZZZZ+
+ZZZZZZZZZZZZZZEZFQURRPQSSTTVUTUUTSTTUUUUTTSSSSTUUUSQQQSTUUUTTTTUUUTTUTSSRPPNKJNPRSPZEZZZZZZZZZZZZZZZ+
+ZZZZZZZZZZZZZZZEZPVSRQQSSTUVVUUVVUUVVVUTTTSSSTTUUUTQQQSTUUUUTTTUUUUUUTTSRQOMLLNQSTOZEZZZZZZZZZZZZZZZ+
+ZZZZZZZZZZZZZZZEZOUSRRRSSUUUVUUUUUUVUUUTTTTTSTTUVVTQRRRTVUUTTUUTTUUTUTTSRQOMMPPRSTOZEZZZZZZZZZZZZZZZ+
+ZZZZZZZZZZZZZZZEZLUSSSSSTTUUUVUUUUUUUUVUTTTTTTUUUUSRRRSTUUVUUUTTUTUUTTTSQQOMNRRQSSHZEZZZZZZZZZZZZZZZ+
+ZZZZZZZZZZZZZZZEZJSTSSRSSTUUUVUUUUUUVVVUTTTTTTTUVUTQPQSSTUVVVVUUUUUUTTTSQPOLNQRRSQEZZZZZZZZZZZZZZZZZ+
+ZZZZZZZZZZZZZZZZZFRSUSRSTTTUUVVVVVVVVVUUTTTSSSTUVVTQOQRSTUVVVVVVVUVUUTSSQONLOORSQPEZZZZZZZZZZZZZZZZZ+
+ZZZZZZZZZZZZZZZZZEOTUTRRSSTUVVWVVVVVWVUUTSSSSSTVVVTPQSSRSTUUVVVVVUUUUTSRPNNLOQSRNMEZZZZZZZZZZZZZZZZZ+
+ZZZZZZZZZZZZZZZZEZHTTTQRSSUVVVVVVVVVVVVTTSTTTTUVWXUQRTSSQRTUVVUUVUUTTTSRPNMLMPRQQHZEZZZZZZZZZZZZZZZZ+
+ZZZZZZZZZZZZZZZZEZFQTSQQRTTUVVVVVVVWVUTSSTTTTTUVWXURRSSSPPQRTTUUUUTTTSRQONMLMPQQNFZEZZZZZZZZZZZZZZZZ+
+ZZZZZZZZZZZZZZZZEZEOTSSQQSTTUUUVVVUVVTSSSTTTSTUUUUURQSRRQQRQRSTUUTTTSSRPNMMLORRQKZEZZZZZZZZZZZZZZZZZ+
+ZZZZZZZZZZZZZZZZZEZMTSTQQRSTTUUUUUUTTSSSRSOMNPRTTTSOMKKMOSSRQRSTTTTSRRQOMNMMPRQPJZEZZZZZZZZZZZZZZZZZ+
+ZZZZZZZZZZZZZZZZZEZFRTTQPQRTTUUUTTTSRSTURNIGHKPQRROLGEFHMRSTRPQRRRRRRQOMMNMNQRPOEZZZZZZZZZZZZZZZZZZZ+
+ZZZZZZZZZZZZZZZZZZEZKPRRQPQSSTTTSSSRRTUUSNLMNLLNNNLHHIJKORSTTRPPQQQQQPNMMNMMPPPLZEZZZZZZZZZZZZZZZZZZ+
+ZZZZZZZZZZZZZZZZZZZEZHOPQPQRRSTSSRQRUVUUSRRQPOMLKJIIKLNOPRSSTTRPPPPPPNMMNNMONNKZEZZZZZZZZZZZZZZZZZZZ+
+ZZZZZZZZZZZZZZZZZZZZEZFKQQPPQRRSRRSTUUUTTSSQQPOMIHILNOPQQRRSRSSSPPPONMMNONNSOGZEZZZZZZZZZZZZZZZZZZZZ+
+ZZZZZZZZZZZZZZZZZZZZZEZFQRQPPQQQRSTUTUUUUTSRRQQOKKLNPPQSRRRQRRRSQPOONMMOOMPNZEEZZZZZZZZZZZZZZZZZZZZZ+
+ZZZZZZZZZZZZZZZZZZZZZEEGQRRQQRRRSTTTTTTTUTTSSSRONNNPQQRRRRRQQRRRRPPPONNPONMFEZZZZZZZZZZZZZZZZZZZZZZZ+
+ZZZZZZZZZZZZZZZZZZZZZEZGQRRRRRRRSTSSSSTTTTTTSSRQQQRRRRRRQRQPPQRSRQQQPPPPPNLZEZZZZZZZZZZZZZZZZZZZZZZZ+
+ZZZZZZZZZZZZZZZZZZZZZEZFPRRSRSSRSSSRQRSSTTTTUUVUTTUUSSSSSRPNNORRQPRQQPPPPNNEEZZZZZZZZZZZZZZZZZZZZZZZ+
+ZZZZZZZZZZZZZZZZZZZZZEZFORRSSTTSRSSRPQSTTUUTUTTUUUURQRRRQQOMKPSRPPRQQPPQOMMZZZZZZZZZZZZZZZZZZZZZZZZZ+
+ZZZZZZZZZZZZZZZZZZZZZZZEMRSSSTTTRSTSPMQRRQQPQQQRSSQPPNLKKJIIMRTRPRSRPPQPNMIEZZZZZZZZZZZZZZZZZZZZZZZZ+
+ZZZZZZZZZZZZZZZZZZZZZZEZKRSSRSTTSRSTSOLLLLMMNOPPPPOONLLLMLMPTUTQQRSQOPQPNNFZEZZZZZZZZZZZZZZZZZZZZZZZ+
+ZZZZZZZZZZZZZZZZZZZZZZEZJQRSRRSTTSSTUURQPQRQQQPPPPQPQSSRRRQQSUSQRRRPPQQPLNGZEZZZZZZZZZZZZZZZZZZZZZZZ+
+ZZZZZZZZZZZZZZZZZZZZZZEZGORRRRRSTTSTTTSSSSSTUVVVVUUVUSRRRQORTTRQQRQQPPPNMIEEZZZZZZZZZZZZZZZZZZZZZZZZ+
+ZZZZZZZZZZZZZZZZZZZZZZZEZNPRSRRRSSSSTTSQRSRRSTVWWVVUSRQRPNPSTSSRQQPQQQOLMJZEZZZZZZZZZZZZZZZZZZZZZZZZ+
+ZZZZZZZZZZZZZZZZZZZZZZZEZKOQRRRRRSSSTTTRQQRRRRSTTTTSRRPNMNRSSSRRQQPPPPNLKGEZZZZZZZZZZZZZZZZZZZZZZZZZ+
+ZZZZZZZZZZZZZZZZZZZZZZZEZFOOQRRRRSRSSSSSRPOOPQQQQQQPONLKNQRRRRRQQQPPPOMKKZEZZZZZZZZZZZZZZZZZZZZZZZZZ+
+ZZZZZZZZZZZZZZZZZZZZZZZZEEKOPQQQQRRSSSSSRQONMLLLLKKKJJKNPQRRRRQQPPQPPNKMEEZZZZZZZZZZZZZZZZZZZZZZZZZZ+
+ZZZZZZZZZZZZZZZZZZZZZZZZEZGNOPQQQRRSSTTSSRQOMLKKLKKKKLNPQQSRRQQQPQQPNLJMEZZZZZZZZZZZZZZZZZZZZZZZZZZZ+
+ZZZZZZZZZZZZZZZZZZZZZZZZZEZJNOQQQRRRSSSSSSRRPOONNMMMNOQQQRSRRRQPQQOOMKJKEZZZZZZZZZZZZZZZZZZZZZZZZZZZ+
+ZZZZZZZZZZZZZZZZZZZZZZZZZZZELNPQQQRRSSSSSSTSSRQQQPQQQRRRSSSRRRQPPOOMKIKHZZZZZZZZZZZZZZZZZZZZZZZZZZZZ+
+ZZZZZZZZZZZZZZZZZZZZZZZZZZEEGONPPPQRSSSSTTTUTTSTTSSSSSTTTSSRQQPOONNKJILGEEZZZZZZZZZZZZZZZZZZZZZZZZZZ+
+ZZZZZZZZZZZZZZZZZZZZZZZZZZEZJOMNPPPQSSTTTTUUTUUTTTUUTSSTSSRRRQONMLKJIIKKZZZZZZZZZZZZZZZZZZZZZZZZZZZZ+
+ZZZZZZZZZZZZZZZZZZZZZZZZZEZIJMNLNOOPRRSTTTTTTTTTTTTTTSTTSRSRQPNLLKIHHJKJJZEZZZZZZZZZZZZZZZZZZZZZZZZZ+
+ZZZZZZZZZZZZZZZZZZZZZZZZEZEJEMOLLLMOQRSSTSSTTTTTSSTSSSSSRRRQPNLKJIHHIJLFIKZEEZZZZZZZZZZZZZZZZZZZZZZZ+
+ZZZZZZZZZZZZZZZZZZZZZZZEZELGFMPMLKLLORSSSSSSSTTSTSSSSSSRRQQQOMJIHHHIIJKGEJKZZZZZZZZZZZZZZZZZZZZZZZZZ+
+ZZZZZZZZZZZZZZZZZZZZZZEZELIFFLPNLKKKLORRSSSSSSSSSSSSSSRQPQQOMJHHHHHIJKKFFFIKEEEZZZZZZZZZZZZZZZZZZZZZ+
+ZZZZZZZZZZZZZZZZZZZZZEZEKIGGEKPNMLKKKLORRRRSSRRSSSSRRQPPPPOMIHHHHHIIJKKFFGEJKZZEZZZZZZZZZZZZZZZZZZZZ+
+ZZZZZZZZZZZZZZZZZZZZEZELIGHGEJPONMLKKKLNPQQQQQQQQQQPPONNNMKIHGHHHHIJJKKFEFGEIKGZEEEZZZZZZZZZZZZZZZZZ+
+ZZZZZZZZZZZZZZZEEZZZZGKIGHGGEHOOOMLKKKJKLMNOOOOOONONMLLKKJHGHHHHHIJKKLKEEFFGFGLIZZZZZEEZZZZZZZZZZZZZ+
+ZZZZZZZZZZZZZEEZZZEEKKHGHGGGEHOOOOMLLLKKJJKLLMLLLLLKJIIIHGHHHHHHIJJKKLKFFFFFGFFKKKFEZZZEEZZZZZZZZZZZ+
+ZZZZZZZZZZZEEZZEGIMKJGGGGGGFEHOPOONMLLLLKKJIJJJJIIIIHHGGGHHHHIHIIJKKLLKFEFFFFGGFIJKNJGFZZEEZZZZZZZZZ+
+ZZZZZZEEEZZZZGJKMIHHGHHGGGGGFIOPPONNNMLLLKKJJIIIIHHHGGHHHHHHIIHIJJKLLLKFFGFFFFGGFGGGILLJIZZZZEEZZZZZ+
+ZZZEEEZZZEEHLKKIGGHHHHGGGGGGFJNPPPONNNMLLLKKKJJIIIHHHHHHHHHHIIIJJKLLLMLGFGFFFFGGGGGGGFGJLLLFFZZEEEZZ+
+ZZZZZZFHHLLJIHHHHHHHHHHGGGGGFJNPPPPPONNMMLLKKKJJIIIHHHHHHHIIIIJJKLLMMMLGFGFFFFGGGGGGGHGGGHILMIIEZZZZ+
+ZEEJLJKLJIHHHHHHHHHHHHGGHGGGGKNPQQPPPONNMMLLKKJJIIIHHHHHHIIIIJJKKLMMMMKHFGFGFGGGGGGGGGGGHHGGHJMKLGZZ+
+IMJKKIIHHHHHHHHGHHHHHHHHHHHGGMMOQQQPPPONNMMMLKKJIHHHHHHHIIIIJJJKLMMMMMLHFGFGGGGGGGGGGGGGGGGHGGGHJKNJ+
+IHHHHHHHHHHHHHHHHHHHHHHHGGGGHNNOQQQQPOOONNMMLLKKJIIIHHIIIIIJJJKLMMNMNMLIFGGGGGGGGGGGGGGGGGGGGHHGGGHJ+
+HHHHHHHHHHHHHHHHHHHHHHHHGHHGIOONQRQQQPPONNNMLLLLKJJJIIIIIIIJJKLMMNNNNNMJFGGGGGGGGGGGGGGGGGGGGGGGGGHH+
+HHHHHHHHHHHHHHHHHHHHHHHHHHHGIPPOPRRRQQQPONNNMLLLLKKJJJIIIJJJKLMNNNNNNNNKFGGGGGGGGGGGGGGGGGGGGGGGGGGH+
+HHHHHHHHHHHHHHHHHHHHHHHHHHHGIPQOPQRRRQQQPONNMMLLLKKJJIJJJJKKKLMNNNNNOOOLFGGGGGGGGGGGGGGGGGGGGGGGGGGH+
+HHHHHHHHHHHHHHHHHHHHHHHHHHHGIQRPPQRRRRRQPPONMMMLLLKKKJKKKKKKMMNNNNNOOOPLFGGGGGGGGGGGHGGGGGGGGGGGGGGG+
+HHHHHHHHHHHHHHHHHHHHHHHHHHHGHPSQPQRRRRRRQQPONNMMMLLLKKKLLLLMMNNOONOPPOQLFGGGGGGGGGGHGFFGGGGGGGGGGGGG+
+HHHHHHHHHHHHHHHGGHHHHHHHHHHGGQTRQQRRRRRRQQQPOONNNMMMMLLLLLMMNNOONNOPPPQKFGGGGGGGGGGGFFGGHGGGGGGGGGGG+
+HHHHHHHHHHHHHHHHGGGHHHHHHHHHGMURQRQRRRRRRQQQPPPONNNNNMMMMMMMNOOOOPPPPQRKFGGGGGGGGGFFGGGGGGGGGGGGGGGG+
+HHHHHHHHHHGHHHHHHHGFFGHHHHHHGFNTRRRRRRRRRRRQQQQPPOONNNNNNMNNOOOOOPPQQQRIGHGGGGGGFFGGGGGGGGGGGGGGGGGG+
+HHHHHHHHGHGHHHHHHHHHGFGHHHHHHGFNTRRRRRRRRRRRQQQPPPPOOOONNNOOOOOOPPQQQSMGGGGGGGGGGGGGGGGGGGGGGGGGGGGG+
+HHHHHHHHHHHHHHHHHHHHHHGHHHHHGGFFMSRRQQRRRRRRQQPPOOOOONNNNOOOPPPPPQRQSOFGHGGGGGGGGGGGGGGGGGGGGGGGGGGG+
+HHHHHHHHHHGGHHHHHHHHHHHHHHHHHGGFFLRSQQQRRRRRRQPPOONNNNNOOPPPPPPPQRRTPGFGHGGGGGGGGGGGGGGGGGGGGGGGGGGG+
+HHHHHHHHHHGGHHHHHHHHHHHHHHHHHGGGGFKRSQQQQRRRRQQPOONOOOOOPPPPQPPQQRUPGEFGHGGGGGGGGGGGGGGGGGGGGGGGGGGG+
+HHHHHHHHHHGGHHHHHHHHHHHHHHHHHGGGGGFIPSQQQRRRRRQQPOOOPPPPPPQQQQPQSTOGFGFGHGGGGGGGGGGGGGGGGGGGGGGGGGGG+
+HHHHHHHHHHGGHHHHHHHHHHHHHHHHHGGGGGGFGNSRQRRRRQQQQPPPPPPPQQRRQPQSSLFFFGFGHGGGGGGGGGGGGGGGGGFGGGGGGGGG+
+HHHHHHHHHHHGHHHHHHHHHHHHHHHHGGGGGGGGFFJPRRRSSRRQQQPPPPQQRRSRQRSPIFGGGFFGHGGGGGGGGGGGGGGGGGFGGGGGGGGG+
+HHHHHHHHHHHGHHHHHHHHHHHHHHHGGGGGGGGGGGFGKQSSSSRRRQQQQQRRSSSTSQLFFGGGGGFGHGGGGGGGGGGGGGGGHGFGGGGGGGGG+
+HHHHHHHHHHHGHHHHHHHHHHHHHHHHHGGGGGGGGGGGFHMSUTSRRRRRRRRSTUTQKFFGGFGFGGGGHGGGGGGGGGGGGGGGGGFGGGGGGGGG+
+HHHHHHHHHHHGHHHHHHHHHHHHHHHHHGGGGGGGGGGGGFFHNSTTTSSSSTTUSOJFFFGFFFFGGGFGHGGGGGGGGGGGGGGGGGFGGGGGGGGG+
+HHHHHHHHHHHGHHHHHHHHHHHHHHHHHGGGGGGGGGGGGGGFFGLPRSSSSRPLGEEFGFFFFFGGGGFGHGGGGGGGGGGGGGGGGGFGGGGGGGGG+
+HHHHHHHHHHHGHHHHHHHHHHHHHHHHHHGGGGGGGGGGGGGGGFFFGHHHHGFEFFGGFFFGGGGGGFGGHGGGGGGGGGGGGGGGGGGGGGGGGGGG+
+HHHHHHHHHHHGHHHHHHHHHHHHHHHHHHGGGGGGGGGGGFFGGGGFFFFFFFFFFFGFFFGGGGGGFGGGGGGGGGGGGGGGGGGGGGGGGGGGGGGG+
+HHHHHHHGHHHHHHHHHHHHHHHHHHHHHHGGGGGGGGGGGGGFGFFFFGGGFFFFFFFGGGGGGGGGFGGGGGGGGGGGGGGGGGGGGGFGGGGGGGGG+
+HHHHHHHHHHHGGHHHHHHHHHHHHHHHHHGGGGGGGGGGGGGGGGGFFFFFFFFFFGGGFGGGGGGFFGGGGGGGGGGGGGGGGGGGGGGGGGGGGGGG+
+HHHHHHHHHHHGGHHHHHHHHHHHHHHHHHGGGGGGGGGGGGGGGGGGGGGGGGGGGGGFFGGGGGGFGGGGGGGGGGGGGGGGGGGGHGGGGGGGGGGG+
+HHHHHHHGHHHGHHHHHHHHHHHHHHHHHHGFGGGGGGGGGGGFFFGGGGGGGGGGGGFFGGGGGGGFGGGGGGGGGGGGGGGGGGGGGGFGGGGGGGGH+
+HHHHHHHHHHHHHHHHHHHHHHHHHHHHHHGGGGGGGGGGGGGGFFFGGGFFGGGGFFFGGGGGGGGGGGGGHGGGGGGGGHHGGGGGHGFGGGGHGGHH+
++++++++++++++++++++++++++++++++++++++++++++++++++++++++++++++++++++++++++++++++++++++++++++++++++++++
#end