#domain
hospital
#levelname
SACrunch
#colors
blue: 0, A, B, C
#initial
++++++++
+0+ C  +
+ A+   +
+ + +  +
+   B+ +
+ ++++ +
+      +
++++++++
#goal
++++++++
+ +C   +
+  + AB+
+ + +  +
+    + +
+ ++++ +
+      +
++++++++
#end
