#domain
hospital
#levelname
test-level-2
#colors
blue: 1
purple: 0, A
green: 2
#initial
+++++++++++++++
+            ++
+  +          +
+ ++++++++++A +
+ ++    ++++  +
+1++    +++   +
+  +     +    +
+            2+
++    0       +
+++++++++++++++
#goal
+++++++++++++++
+  2         ++
+  +         1+
+ ++++++++++  +
+ ++    ++++  +
+ ++  A +++   +
+  +     +    +
+             +
++     0      +
+++++++++++++++
#end
