#domain
hospital
#levelname
test-level-1
#colors
red: 1
cyan: 2, A
green: 0
#initial
+++++++++++++++
+   2 ++   ++++
+            ++
+ +++1 +++++  +
+  +++++++++ 0+
+  ++++++++++ +
+   A +++++++ +
+          +  +
+             +
+++++++++++++++
#goal
+++++++++++++++
+    2++   ++++
+         0  ++
+ +++  +++++1 +
+  +++++++++  +
+  ++++++++++A+
+     +++++++ +
+          +  +
+             +
+++++++++++++++
#end
