#domain
hospital
#levelname
test-level-0
#colors
green: 2, 1, B
yellow: 4, 0, D, E
purple: 3, C, A
#initial
+++++++++++++++
+             +
+  ++  2      +
+B++++ E +++  +
+  +++3   ++  +
+  +++   1++  +
++c ++   ++++ +
+++       ++  +
+++4 a     0 d+
+++++++++++++++
#goal
+++++++++++++++
+    a02   d1 +
+  ++         +
+ ++++   +++  +
+  +++    ++ e+
+b +++  4 ++  +
++  ++   ++++ +
+++ 3     ++  +
+++       c   +
+++++++++++++++
#end
