#domain
hospital
#levelname
FastCipka_test1_sub1
#colors
blue: 0, C, D, F
#initial
++++++++++++++
+ C          +
+D0F         +
+            +
+            +
+            +
+++ ++++++++ +
+      +  +  +
+      +  +  +
+         +  +
+         +  +
+      +  +  +
+      +  +  +
+      +  +  +
++++++++++++++
#goal
++++++++++++++
+         CD +
+            + 
+           F+
+            +
+            +
+++ ++++++++ + 
+      +  +  +
+      +  +  +
+         +  +
+         +  +
+      +  +  +
+      +  +  +
+      +  +  +
++++++++++++++
#end
