#domain
hospital
#levelname
FastCipka_test1
#colors
purple: 1, A, B
blue: 0, C, D, F
#initial
++++++++++++++++++++++++++++
+ C                        +
+D0F                       +
+                          +
+                          +
+                          +
+++ ++++++++++++++++++++++ +
+         +             +  +
+         +             +  +
+                       +  +
+                       +  +
+         +            1+A +
+         +             +  +
+         +             +  +
++++++++++++++++++++++++++++
#goal
++++++++++++++++++++++++++++
+                       CD +
+                          + 
+                         F+
+                          +
+                          +
+++ ++++++++++++++++++++++ + 
+         +             +  +
+         +             +  +
+                       +  +
+                       +  +
+         +             +  +
+         +             +  +
+         +            A+  +
++++++++++++++++++++++++++++
#end
