#domain
hospital
#levelname
FastCipka_test1_sub2
#colors
purple: 0, A, B
#initial
++++++++++++++
+            +
+            +
+            +
+            +
+            +
+++ ++++++++ +
+      +  +  +
+      +  +  +
+         +  +
+         +  +
+      + 0+A +
+      +  +  +
+      +  +  +
++++++++++++++
#goal
++++++++++++++
+            +
+            + 
+            +
+            +
+            +
+++ ++++++++ + 
+      +  +  +
+      +  +  +
+         +  +
+         +  +
+      +  +  +
+      +  +  +
+      + A+  +
++++++++++++++
#end
