#domain
hospital
#levelname
sublevel1
#colors
green: 0, 1, A
#initial
+++++++++++++++++++++++++++
+0                       1+
+ +++++++++++++++++++++++++
+ +   +   +   +++++++++++++
+ + + + + + + +++++++ +++++
+   +   +   +            A+
+++++++++++++++++++++++++++
#goal
+++++++++++++++++++++++++++
+             1          A+
+ +++++++++++++++++++++++++
+ +   +   +   +++++++++++++
+ + + + + + + +++++++ +++++
+   +   +   +    0        +
+++++++++++++++++++++++++++
#end