#domain
hospital
#levelname
Tahini
#colors
blue: 0,T,A,H,I,N,M
red: 1,Z
#initial
+++++++++++++++++++++++
+                   0 +
+       1      Z      +
+ T   ++++ +++++      +
+     +        +  I   +
+     +        +      +
+    ++        ++     +
+ A  +          +     +
+    +            N   +
+    +          +     +
+    +          +     +
+    +          +     +
+  M +          +  A  +
+    ++++++++++++     +
+      H     I        +
+++++++++++++++++++++++
#goal
+++++++++++++++++++++++
+                   0 +
+       1             +
+     ++++Z+++++      +
+     +        +      +
+     +        +      +
+    ++        ++     +
+    +          +     +
+    +                +
+    +          +     +
+    +          +     +
+    +          +     +
+    +MA TAHINI +     +
+    ++++++++++++     +
+                     +
+++++++++++++++++++++++
#end
