#domain
hospital
#levelname
test-level-0
#colors
red: 1, 0
purple: 2, A
#initial
+++++++++++++++
+++++++     +++
++  ++0      ++
+    +  +++   +
+ 1     ++++  +
+  ++  +++++  +
+ ++++++++++  +
+  ++       2 +
+         A   +
+++++++++++++++
#goal
+++++++++++++++
+++++++     +++
++  ++       ++
+    +  +++0  +
+       ++++  +
+  ++  +++++  +
+ ++++++++++  +
+ 1++     2   +
+          A  +
+++++++++++++++
#end
