#domain
hospital
#levelname
mishmash
#colors
blue: 0, 1, A, I
green: 2, 3, 5, B
brown: 4, 6
cyan: 7, D, E, M, S, H
pink: 8
grey: Z
#initial
++++++++++++++
+34   ZZM    +
+++ ++ZZM M  +
+5   6ZZMMM  +
+M   MZZMM   +
++++++++++++++
++++++++++++++
+1A B2++     +
+++ ++++  0  +
+++ ++++     +
+     ++     +
++++++++++++++
#goal
++++++++++++++
+6   5       +
+++ ++       +
+4   3       +
+            +
++++++++++++++
++++++++++++++
+     ++     +
+++ ++++     +
+++ ++++     +
+B   A++     +
++++++++++++++
#end