#domain
hospital
#levelname
mishmash
#colors
blue: 0, 1, A, I
green: 3, 5, B
brown: 4, 6, 2
cyan: D, E, M, S, H
#initial
++++++++++++++
+34   +++++20+
+++ ++++++++1+
+5   6++++++++
++   +++++++++
++++++++++++++
++++++++++++++
++++++++++++++
++++++++++++++
++++++++++++++
++++++++++++++
++++++++++++++
#goal
++++++++++++++
+6   5+++++20+
+++ ++++++++1+
+4   3++++++++
++   +++++++++
++++++++++++++
++++++++++++++
++++++++++++++
++++++++++++++
++++++++++++++
++++++++++++++
++++++++++++++
#end